Symbol	Description
A	Agilent Technologies Inc.
AA	Alcoa Inc.
AAI	AirTran Holdings Inc.
AAP	Advance Auto Parts Inc
AAR	AMR Corporation
AAV	ADVANTAGE ENERGY INCOME FUND
AB	Alliance Capital Management Holding L.P.
ABA	Alabama Power Company
ABB	ABB Ltd
ABC	AmerisourceBergen Corporation (Holding Co)
ABD	Acco Brands Corporation
ABG	Asbury Automotive Group Inc
ABH	Abitibibowater Inc
ABK	Ambac Financial Group Inc.
ABK-Z	Ambac Financial Group Inc.
ABM	ABM Industries Incorporated
ABN-E	ABN Amro Holding N.V.
ABN-F	ABN Amro Holding N.V.
ABN-G	ABN Amro Holding N.V.
ABR	Arbor Realty Trust
ABT	Abbott Laboratories
ABV	Companhia de Bebidas das Americas - AmBev
ABV.C	Companhia de Bebidas das Americas - AmBev
ABW-A	Associated Banc-Corp
ABX	Barrick Gold Corporation
ACC	American Campus Communities Inc
ACE	Ace
ACF	AmeriCredit Corporation
ACG	Alliance Capital Management Holding L.P.
ACH	Aluminum Corporation of China Ltd
ACI	Arch Coal Inc.
ACL	Alcon Inc
ACM	Aecom Technology Corporation
ACN	Accenture Ltd.
ACO	Amcol International Corporation
ACS	Affiliated Computer Services Inc.
ACV	Alberto-Culver Company
ADC	Agree Realty Corporation
ADF	Alliance Capital Management Holding L.P.
ADI	Analog Devices Inc.
ADM	Archer-Daniels-Midland Company
ADM-A	Archer-Daniels-Midland Company
ADS	Alliance Data Systems Corporation
ADX	Adams Express Company (The)
AEA	Advance America Cash Advance Centers Inc.
AEB	Aegon NV
AEC	Associated Estates Realty Corporation
AEC-B	Associated Estates Realty Corporation
AED	Aegon NV
AEE	Ameren Corporation
AEF	Aegon NV
AEG	Aegon NV
AEH	Aegon NV
AEL	American Equity Investment Life Holding Company
AEM	Agnico-Eagle Mines
AEO	American Eagle Outfitters Inc.
AEP	American Electric Power Company Inc.
AEP-A	American Electric Power Company Inc.
AER	Aercap Holdings N.V.
AES	Aes Trust
AES-C	Aes Trust
AET	Aetna Inc.
AEV	Aegon NV
AF	Astoria Financial Corporation
AFB	Alliance National Municipal Income Fund Inc
AFC	Allied Capital Corporation
AFE	American Financial Group Inc.
AFF	American International Group Inc.
AFG	American Financial Group Inc.
AFL	AFLAC Incorporated
AFN	Alesco Financial Inc
AG	AGCO Corporation
AGC	Advent Claymore Convertible Securities and Income Fund
AGD	Alpine Global Dynamic Dividend Fund
AGM	Federal Agricultural Mortgage Corporation
AGM.A	Federal Agric Mtg Corp
AGN	Allergan Inc.
AGO	Assured Guaranty Ltd
AGP	AMERIGROUP Corporation
AGU	Agrium Inc.
AHC	A.H. Belo Corporation
AHD	Atlas Pipeline Holdings L.P.
AHL	Aspen Insurance Holdings
AHL-A	Aspen Insurance Holdings
AHL.P	Aspen Insurance Holdings
AHR	Anthracite Capital Inc.
AHR-C	Anthracite Capital Inc.
AHR-D	Anthracite Capital Inc.
AHS	AMN Healthcare Services Inc
AHT	Ashford Hospitality Trust Inc
AHT-A	Ashford Hospitality Trust Inc
AHT-D	Ashford Hospitality Trust Inc
AIB	Allied Irish Banks p.l.c.
AIG	American International Group Inc.
AIG-A	American International Group Inc.
AIN	Albany International Corporation
AIQ	Alliance Imaging Inc.
AIR	AAR Corp.
AIT	Applied Industrial Technologies Inc.
AIV	Apartment Investment and Management Company
AIV-G	Apartment Investment and Management Company
AIV-T	Apartment Investment and Management Company
AIV-U	Apartment Investment and Management Company
AIV-V	Apartment Investment and Management Company
AIV-Y	Apartment Investment and Management Company
AIZ	Assurant Inc.
AJG	Arthur J. Gallagher & Co.
AKF	Ambac Financial Group Inc.
AKO.A	Embotelladora Andina S.A.
AKO.B	Embotelladora Andina S.A.
AKP	Alliance California Municipal Income Fund Inc
AKR	Acadia Realty Trust
AKS	AK Steel Holding Corporation
AKT	Ambac Financial Group Inc.
ALB	Albemarle Corporation
ALC	Assisted Living Concepts Inc. New
ALD	Allied Capital Corporation
ALE	Allete Inc.
ALF	Alabama Power Company
ALG	Alamo Group Inc.
ALJ	Alon USA Energy Inc.
ALK	Alaska Air Group Inc.
ALL	Allstate Corporation (The)
ALM	Alabama Power Company
ALO	Alpharma Inc.
ALP-N	Alabama Power Company
ALP-O	Alabama Power Company
ALP-P	Alabama Power Company
ALQ	Alabama Power Company
ALU	Alcatel
ALV	Autoliv Inc.
ALX	Alexander's Inc.
ALY	Allis-Chalmers Corporation
ALZ	Alabama Power Company
AM	American Greetings Corporation
AMB	AMB Property Corporation
AMB-L	AMB Property Corporation
AMB-M	AMB Property Corporation
AMB-O	AMB Property Corporation
AMB-P	AMB Property Corporation
AMD	Advanced Micro Devices Inc.
AME	AMTEK Inc.
AMG	Affiliated Managers Group Inc.
AMN	Ameron International Corporation
AMP	AMERIPRISE FINANCIAL SERVICES INC.
AMR	AMR Corporation
AMT	American Tower Corporation
AMX	America Movil S.A.B. de C.V.
AN	AutoNation Inc.
ANF	Abercrombie & Fitch Company
ANH	Anworth Mortgage Asset  Corporation
ANH-A	Anworth Mortgage Asset  Corporation
ANH-B	Anworth Mortgage Asset  Corporation
ANL	American Land Lease Inc.
ANL-A	American Land Lease Inc.
ANN	AnnTaylor Stores Corporation
ANR	Alpha Natural Resources inc.
ANW	Aegean Marine Petroleum Network Inc.
AO-A	Amerco
AOB	American Oriental Bioengineering Inc.
AOC	Aon Corporation
AOD	Alpine Total Dynamic Dividend Fund
AOI	Alliance One International Inc.
AOS	Smith (a.o.) Corporation
AP	Ampco-Pittsburgh Corporation
APA	Apache Corporation
APB	Asia Pacific Fund Inc. (The)
APC	Anadarko Petroleum Corporation
APD	Air Products and Chemicals Inc.
APF	Morgan Stanley Asia-pacific Fund, Inc.
APH	Amphenol Corporation
APL	Atlas Pipeline Partners L.P.
APU	AmeriGas Partners L.P.
APX	Blackrock APEX Municipal Fund Inc.
ARA	Aracruz Celulose S.A.
ARB	Arbitron Inc.
ARD	Arena Resources Inc
ARE	Alexandria Real Estate Equities Inc.
ARE-C	Alexandria Real Estate Equities Inc.
ARG	Airgas Inc.
ARH-A	Arch Capital Group Ltd.
ARH-B	Arch Capital Group Ltd.
ARJ	Arch Chemicals Inc.
ARK	Senior High Income Portfolio, Inc.
ARL	American Realty Investors Inc.
ARM	ArvinMeritor Inc.
ARO	Aeropostale Inc
ARP	American Reprographics Company
ARW	Arrow Electronics Inc.
ASA	ASA
ASF	Administaff Inc.
ASG	Liberty All-star Growth Fund, Inc.
ASH	Ashland Inc.
ASI	American Safety Insurance Holdings Ltd.
ASP	American Strategic Income Portfolio
ASR	Grupo Aeroportuario Del Sureste, S.a. De C.v.
ASX	Advanced Semiconductor Engineering Inc.
ATE	Advantest Corporation (Kabushiki Kaisha Advantest) ADS
ATG	AGL Resources Inc.
ATI	Allegheny Technologies Incorporated
ATK	Alliant Techsystems Inc.
ATN	Atlas Energy Resources LLC
ATO	Atmos Energy Corporation
ATR	AptarGroup Inc.
ATT	AT&T Inc.
ATU	Actuant Corporation
ATV	Acorn International Inc.
ATW	Atwood Oceanics Inc.
AU	AngloGold Ashanti Ltd.
AUO	AU Optronics Corp
AUY	YAMANA GOLD INC
AVA	Avista Corporation
AVB	AvalonBay Communities Inc.
AVD	American Vanguard Corporation
AVF	American International Group Inc.
AVK	Advent Claymore Convertible Securities and Income Fund
AVP	Avon Products Inc.
AVR	Aventine Renewable Energy Holdings Inc.
AVT	Avnet Inc.
AVX	AVX Corporation
AVY	Avery Dennison Corporation
AVY-A	Avery Dennison Corporation
AWC	Alumina Ltd
AWF	Alliance World Dollar Government Fund II
AWH	Allied World Assurance Company Holdings LTD.
AWI	Armstrong World Industries Inc
AWK	American Water Works Company Inc.
AWP	Alpine Global Premier Properties Fund
AWR	American States Water Company
AXA	AXA
AXB	ALEXANDER & BALDWIN INC
AXE	Anixter International Inc.
AXL	American Axle & Manufacturing Holdings Inc.
AXP	American Express Company
AXR	AMREP Corporation
AXS	Axis Capital Holdings
AXS-A	Axis Capital Holdings
AYE	Allegheny Energy Inc.
AYI	Acuity Brands Inc
AYN	Alliance New York Municipal Income Fund Inc
AYR	Aircastle
AZ	Allianz SE
AZM	Allianz SE
AZN	Astrazeneca PLC
AZO	AutoZone Inc.
AZZ	AZZ Incorporated
B	Barnes Group Inc.
BA	Boeing Company (The)
BAC	Bank of America Corporation
BAC-B	Bank of America Corporation
BAC-C	Bank of America Corporation
BAC-D	Bank of America Corporation
BAC-E	Bank of America Corporation
BAC-H	Bank of America Corporation
BAC-I	Bank of America Corporation
BAC-J	Bank of America Corporation
BAC-L	Bank of America Corporation
BAC-U	Bank of America Corporation
BAC-V	Bank of America Corporation
BAC-W	Bank of America Corporation
BAC-X	Bank of America Corporation
BAC-Y	Bank of America Corporation
BAC-Z	Bank of America Corporation
BAF	BLACKROCK FLORIDA IURED MUNICIPAL INCOME TRUST
BAK	Copene-Petroquimica do Nordeste
BAM	Brookfield Asset Management Inc
BAP	Credicorp Ltd.
BAS	Basic Energy Services Inc.
BAX	Baxter International Inc.
BBD	Banco Bradesco Sa
BBF	BlackRock Florida Municipal Income Trust
BBG	Bill Barrett Corporation
BBI	Blockbuster Inc.
BBI.B	Blockbuster Inc.
BBK	Blackrock Municipal Bond Trust
BBL	BHP Billiton plc
BBT	BB&T Corporation
BBT-A	BB& T CAPITAL TRUST V
BBV	Banco Bilbao Viscaya Argentaria S.A.
BBW	Build-A-Bear Workshop Inc.
BBX	BankAtlantic Bancorp Inc.
BBY	Best Buy Co. Inc.
BC	Brunswick Corporation
BCA	Corpbanca
BCE	BCE Inc.
BCF	Blackrock Real Asset Equity Trust
BCH	Banco De Chile
BCK	Blackrock California Insured Municipal Income Trust
BCO	Brink's Company (The)
BCR	C.R. Bard Inc.
BCS	Barclays PLC
BCS-A	Barclays PLC
BCS-C	Barclays PLC
BCS-D	Barclays PLC
BCS.P	Barclays PLC
BDC	Belden CDT Inc
BDF	Rivus Bond Fund
BDJ	Blackrock Enhanced Dividend Achievers Trust
BDK	Black & Decker Corporation (The)
BDN	Brandywine Realty Trust
BDN-C	Brandywine Realty Trust
BDN-D	Brandywine Realty Trust
BDT	Blackrock Strategic Dividend Achievers
BDV	Blackrock Dividend Achievers Trust
BDX	Becton Dickinson and Company
BEC	Beckman Coulter Inc.
BEE	Strategic Hotels & Resorts Inc
BEE-A	SRATEGIC HOTELS & RES    ORTS IN
BEE-B	Strategic Hotels & Resorts I
BEE-C	Strategic Hotels & Resorts I
BEN	Franklin Resources, Inc.
BEO	Enhanced S&P 500 Covered Call Fund Inc.
BEP	S&p 500 Covered Call Fund Inc.
BEZ	Baldor Electric Company
BF.A	Brown-Forman Corporation
BF.B	Brown-Forman Corporation
BFD	Blackrock Global Equity Income Trust
BFK	BlackRock Municipal Income Trust
BFO	Blackrock Florida Municipal 2020 Term Trust
BFR	BBVA Banco Frances S.A.
BFS	Saul Centers, Inc.
BFS-A	Saul Ctrs Inc
BFS-B	SAUL CENTERS INC 9% SERIES B
BFZ	BlackRock California Municipal Income Trust
BG	Bunge
BGC	General Cable Corporation
BGE-B	Baltimore Gas & Electric Company
BGF	B&G Foods Holdings Corp.
BGG	Briggs & Stratton Corporation
BGH	Buckeye GP Holdings LP
BGM	General Motors Corporation
BGP	Borders Group Inc.
BGR	Black Rock Global Energy and Resources Trust
BGS	B&G Foods Holdings Corp.
BGT	Blackrock Global
BGY	BLACKROCK INTERNATIONAL LTD.
BHD	Blackrock Strategic Bond Trust
BHE	Benchmark Electronics Inc.
BHI	Baker Hughes Incorporated
BHK	Blackrock Core Bond Trust
BHL	Blackrock Defined Opportunity Credit Trust
BHP	BHP Billiton
BHS	Brookfield Homes Corp
BHY	Blackrock High Yield Trust (The)
BID	Sotheby's Holdings, Inc.
BIE	Blackrock Florida Municipal Bond Trust
BIF	Uslife Income Fund, Inc.
BIG	Big Lots Inc.
BIO	BIO RAD LABS CL A
BIO.B	BIO RAD LABS CL B
BIP	Brookfield Infrastructure Partners LP
BJ	BJ's Wholesale Club Inc.
BJS	BJ Services Company
BJZ	Blackrock California Municipal 2018 Term Trust
BK	Bank of New York Mellon Corporation (The)
BK-E	Bank of New York Mellon Corporation (The)
BK-F	Bank of New York Mellon Corporation (The)
BKC	Burger King Holdings Inc.
BKD	Brookdale Senior Living Inc.
BKE	Buckle Inc. (The)
BKH	Black Hills Corporation
BKI	Buckeye Technologies Inc.
BKK	Blackrock Municipal 2020 Term Trust
BKN	BlackRock Investment Quality Municipal Trust Inc. (The)
BKS	Barnes & Noble Inc.
BKT	BlackRock Income Trust Inc. (The)
BLC	Belo Corporation
BLH	Blackrock New York Municipal 2018 Term Trust
BLK	BlackRock Inc.
BLL	Ball Corporation
BLT	Blount International Inc.
BLU	Blue Chip Value Fund Inc.
BLW	Citigroup Inc.
BLX	Banco Latinoamericano de Exportaciones S.A.
BMA	Banco Macro S.A.
BMC	BMC Software Inc.
BME	Blackrock Health Sciences Trust
BMI	Badger Meter Inc.
BML-G	BANK AMERICA DEP G
BML-H	BANK AMERICA DEP H
BML-I	BANK AMERICA DEP I
BML-J	BANK AMERICA DEP J
BML-L	BANK AMERICA DEP L
BML-N	BANK AMERICA DEP N
BML-O	BANK AMERICA DEP O
BML-Q	BANK AMERICA DEP Q
BMO	Bank Of Montreal
BMR	Biomed Realty Trust
BMR-A	Biomed Realty Trust
BMS	Bemis Company Inc.
BMT	BlackRock Insured Municipal Term Trust Inc. (The)
BMY	Bristol-Myers Squibb Company
BNA	BlackRock Income Opportunity Trust Inc. (The)
BNE	Bowne & Co. Inc.
BNI	Burlington Northern Santa Fe Corporation
BNJ	BlackRock New Jersey Municipal Income Trust
BNS	Bank of Nova Scotia (The)
BNY	BlackRock New York Municipal Income Trust
BOE	Blackrock Global
BOH	Bank of Hawaii Corporation
BP	BP p.l.c.
BPK	Blackrock Municipal 2018 Term Trust
BPL	Buckeye Partners L.P.
BPO	Brookfield Properties Corporation
BPP	Blackrock Preferred Oopportunity Trust
BPT	BP Prudhoe Bay Royalty Trust
BQH	Blackrock New York Municipal Bond Trust
BQR	BlackRock Ecosolutions Investment Trust
BR	Broadridge Financial Solutions LLC
BRC	Brady Corporation
BRE	BRE Properties Inc.
BRE-C	BRE Properties Inc.
BRE-D	BRE Properties Inc.
BRK.A	Berkshire Hathaway Inc.
BRK.B	Berkshire Hathaway Inc.
BRL	Barr Pharmaceuticals Inc.
BRO	Brown & Brown Inc.
BRP	Brasil Telecom Participacoes S.A.
BRS	Bristow Group Inc
BRS.P	Bristow Group Inc
BRT	BRT Realty Trust
BRY	Berry Petroleum Company
BSC-X	Bear Stearns Companies Inc (The)
BSD	BlackRock Strategic Municipal Trust Inc. (The)
BSE	Blackrock New York Insured Municipal Income Trust
BSI	Blue Square - Israel Ltd.
BSP	American Strategic Income Portfolio II
BSX	Boston Scientific Corporation
BSY	British Sky Broadcasting Group plc
BT	BT Group plc
BTA	BlackRock Long-Term Municipal Advantage Trust
BTE	Baytex Energy Trust
BTF	Boulder Total Return Fund Inc.
BTH	Blyth Inc.
BTM	Brasil Telecom Participacoes S.A.
BTO	John Hancock Bank And Thrift Opportunity Fund
BTU	Peabody Energy Corporation
BTZ	Blackrock Preferred
BVF	Biovail Corporation
BVN	Compania Mina Buenaventura S.A.
BW	Brush Engineered Materials Inc.
BWA	BorgWarner Inc.
BWC	Blackrock World Investment Trust
BWF	WELLS FARGO CAPITAL XII
BWP	Boardwalk Pipeline Partners
BWS	Brown Shoe Company Inc.
BWY	Bway Holding Company
BX	THE BLACKSTONE GROUP LP
BXC	Bluelinx Holdings Inc.
BXG	Bluegreen Corporation
BXP	Boston Properties Inc.
BXS	BancorpSouth Inc.
BXS-A	BancorpSouth Inc.
BYD	Boyd Gaming Corporation
BYI	Bally Technologies Inc.
BYM	Blackrock Insured Municipal Income Trust
BZ	Boise Inc
BZ.W	Boise Inc
BZA	Blackrock California Municipal Bond Trust
BZH	Beazer Homes USA Inc.
C	Citigroup Inc.
C-E	Citigroup Inc.
C-F	Citigroup Inc.
C-G	Citigroup Inc.
C-I	Citigroup Inc.
C-M	Citigroup Inc.
C-O	Citigroup Inc.
C-P	Citigroup Inc.
C-Q	Citigroup Inc.
C-R	Citigroup Inc.
C-S	Citigroup Inc.
C-U	Citigroup Inc.
C-V	Citigroup Inc.
C-W	Citigroup Inc.
C-Z	Citigroup Inc.
CAB	Cabela's Inc
CAE	Cascade Corporation
CAF	Morgan Stanley China A Share Fund Inc.
CAG	ConAgra Foods Inc.
CAH	Cardinal Health Inc.
CAI	CACI International Inc.
CAJ	Canon Inc.
CAL	Continental Airlines Inc.
CAM	Cameron International Corporation
CAP	Cai International Inc.
CAR	Avis Budget Group Inc.
CAS	Castle (A.M.) & Co.
CAT	Caterpillar Inc.
CB	Chubb Corporation (The)
CBB	Cincinnati Bell Inc
CBB-B	Cincinnati Bell Inc
CBC	Capitol Bancorp Ltd.
CBC-A	Capitol Bancorp Ltd.
CBD	Companhia Brasileira de Distribuicao
CBE	Cooper Industries Ltd.
CBG	CB Richard Ellis Group Inc
CBI	Chicago Bridge & Iron Company N.V.
CBK	Christopher & Banks Corporation
CBL	CBL & Associates Properties Inc.
CBL-C	CBL & Associates Properties Inc.
CBL-D	CBL & Associates Properties Inc.
CBM	Cambrex Corporation
CBR	Ciber Inc.
CBS	CBS Corporation
CBS.A	CBS Corporation
CBT	Cabot Corporation
CBU	Community Bank System Inc.
CBY	Cadbury PLC
CBZ	CBIZ Inc.
CCC	Calgon Carbon Corporation
CCE	Coca-Cola Enterprises Inc.
CCH	COCA COLA HELLENIC BOTTLING CO
CCI	Crown Castle International Corporation
CCJ	Cameco Corporation
CCK	Crown Cork & Seal Company Inc.
CCL	Carnival Corporation
CCO	Clear Channel Outdoor Holdings Inc.
CCP-A	Chevy Chase Preferred Capital Corporation
CCS	Comcast Corporation
CCT	Comcast Corporation
CCU	Clear Channel Communications, Inc.
CCW	Comcast Corporation
CCX-C	Chevy Chase Bank FSB
CCZ	Comcast Holdings Inc
CDE	Coeur d'Alene Mines Corporation
CDI	CDI Corporation
CDL	Citadel Broadcasting Corporation
CDR	Cedar Shopping Centers Inc
CDR-A	Cedar Shopping Centers Inc
CE	Celanese Corporation
CE.P	Celanese Corporation
CEA	China Eastern Airlines Corporation Ltd.
CEC	CEC Entertainment Inc.
CEE	Central Europe and Russia Fund Inc. (The)
CEG	Constellation Energy Group Inc.
CEG-A	Constellation Energy Group Inc.
CEL	Cellcom Israel Ltd.
CEM	Crompton Corporation
CEO	CNOOC
CF	CF Industries Holdings Inc.
CFC-A	Countrywide Financial Corporation
CFC-B	Countrywide Financial Corporation
CFD	40/86 Strategic Income Fund
CFI	Culp Inc.
CFL	BRINKS HOME SECURITY HOLDINGS
CFR	Cullen/Frost Bankers Inc.
CFX	Colfax Corporation
CGO	Calamos Global Total Return Fund
CGT	CAE Inc
CGV	Compagnie Generale de Geophysique-Veritas
CGX	Consolidated Graphics Inc.
CHA	China Telecom Corp Ltd
CHB	Champion Enterprises Inc.
CHD	Church & Dwight Company Inc.
CHE	Chemed Corp.
CHG	CH Energy Group Inc.
CHH	Choice Hotels International Inc.
CHI	Calamos Convertible Opportunities and Income Fund
CHK	Chesapeake Energy Corporation
CHK-D	Chesapeake Energy Corporation
CHK-E	Chesapeake Energy Corporation
CHL	China Mobile (Hong Kong) Ltd.
CHN	China Fund Inc. (The)
CHP	C&D Technologies Inc.
CHS	Chico's FAS Inc.
CHT	Chunghwa Telecom Co Ltd
CHU	China Unicom Ltd
CHW	Calamos Global Dynamic Income Fund
CHY	Calamos Convertible and High Income Fund
CI	CIGNA Corporation
CIA	Citizens Inc.
CIB	BanColombia S.A.
CIF	Colonial Intermediate High Income Fund
CIG	Comp En De Mn Cemig ADS
CIG.C	Comp En De Mn Cemig ADS
CII	Blackrock Capital and Income Strategies Fund Inc
CIM	Chimera Investment Corporation
CIR	CIRCOR International Inc.
CIT	CIT Group Inc (DEL)
CIT-A	CIT Group Inc (DEL)
CIT-C	CIT Group Inc (DEL)
CIT-Z	CIT Group Inc (DEL)
CIX	CompX International Inc.
CJA	VALE CAPITAL LIMITED
CJB	VALE CAPITAL LIMITED
CJR	Corus Entertainmt Incorporated
CKH	Seacor Smit Inc.
CKP	Checkpoint Systms Inc.
CKR	CKE Restaurants Inc.
CL	Colgate-Palmolive Company
CLB	Core Laboratories N.V.
CLC	CLARCOR Inc.
CLF	Cleveland-Cliffs Inc.
CLH	Corporate Backed Tr Ctfs
CLI	Mack-cali Realty Corporation
CLP	Colonial Properties Trust
CLP-D	Colonial Properties Trust
CLR	Continental Resources Inc.
CLS	Celestica Inc.
CLW	CLEARWATER PAPER CP
CLX	Clorox Company (The)
CM	Canadian Imperial Bank of Commerce
CMA	Comerica Incorporated
CMC	Commercial Metals Company
CMG	Chipotle Mexican Grill Inc.
CMG.B	Chipotle Mexican Grill Inc.
CMI	Cummins Inc.
CMK	Colonial Intermarket Income Trust I
CMN	Cantel Medical Corp.
CMO	Capstead Mortgage Corporation
CMO-A	Capstead Mortgage Corporation
CMO-B	Capstead Mortgage Corporation
CMP	Compass Minerals Intl Inc
CMS	CMS Energy Corporation
CMS-A	CMS Energy Corporation
CMS-B	CMS Energy Corporation
CMU	Colonial Municipal Income Trust
CMZ	Compton Petroleum Corp
CNA	CNA Financial Corporation
CNB	Colonial BancGroup Inc. (The)
CNB-B	Colonial BancGroup Inc. (The)
CNC	Centene Corporation
CNH	CNH Global N.V.
CNI	Canadian National Railway Company
CNK	Cinemark Holdings Inc
CNL	Cleco Power LLC
CNO	Conseco Inc.
CNP	CenterPoint Energy Inc (Holding Co)
CNQ	Canadian Natural Resources
CNS	Cohn & Steers Inc
CNW	CNF Inc.
CNX	COOL Energy Inc.
COA	Coachmen Industries Inc.
COF	Capital One Financial Corporation
COF-B	Capital One Financial Corporation
COG	Cabot Oil & Gas Corporation
COH	Coach Inc.
COL	Rockwell Collins, Inc.
COO	Cooper Companies Inc. (The)
COP	ConocoPhillips
COT	Cott Corporation
COV	Covidien Ltd.
COY	Blackrock Corporate High Yield Fund Inc.
CP	Canadian Pacific Railway
CPA	Copa Holdings S.A.
CPB	Campbell Soup Company
CPE	Callon Petroleum Company
CPF	CPB Inc.
CPK	Chesapeake Utilities Corporation
CPL	CPFL Energia S.A.
CPN	Calpine Corporation
CPO	Corn Products International Inc.
CPP	Merrill Lynch Depositor, Inc.
CPT	Camden Property Trust
CPV	CBS Corporation
CPX	Complete Production Services Inc.
CPY	CPI Corporation
CQB	Chiquita Brands International Inc.
CQB.W	Chiquita Brands International Inc.
CR	Crane Company
CRD.A	Crawford & Company
CRD.B	Crawford & Company
CRE	Care Investment Trust Inc.
CRH	CRH PLC
CRI	Carter's Inc.
CRK	Comstock Resources Inc.
CRL	Charles River Laboratories International Inc.
CRM	Salesforce.com Inc
CRN	Cornell Corrections Inc.
CRP	Credit Suisse Guernsey BRH
CRR	Carbo Ceramics Inc.
CRS	Carpenter Technology Corporation
CRT	Cross Timbers Royalty Trust
CRY	CryoLife Inc.
CS	Credit Suisse Group
CSA	Cogdell Spencer Inc.
CSB	Colonial BancGroup Inc. (The)
CSC	Computer Sciences Corporation
CSE	CapitalSource Inc
CSH	Cash America International Inc.
CSL	Carlisle Companies Incorporated
CSP	American Strategic Income Portfolio III
CSQ	Calamos Strategic Total Return Fund
CSR	China Security & Surveillance Technology Inc.
CSS	CSS Industries Inc.
CSU	Capital Senior Living Corporation
CSV	Carriage Services Inc.
CSX	CSX Corporation
CT	Capital Trust Inc.
CTB	Cooper Tire & Rubber Company
CTC	Compania de Telecomunicaciones de Chile S.A.
CTL	CenturyTel Inc.
CTR	Cato Corporation (The)
CTS	CTS Corporation
CTV	CommScope Inc.
CTX	Centex Corporation
CTZ-A	Citizens Republic Bancorp Inc.
CUB	CUBIC CP
CUK	Carnival Plc ADS
CUZ	Cousins Properties Incorporated
CUZ-A	Cousins Properties Incorporated
CUZ-B	Cousins Properties Incorporated
CV	Central Vermont Pub Svc
CVA	Danielson Holding Corporation
CVB	Lehman Abs Corporation
CVC	Cablevision Systems Corporation
CVD	Covance Inc.
CVG	Convergys Corporation
CVH	Coventry Health Care Inc.
CVI	CVR Energy Inc.
CVO	Cenveo Inc
CVS	CVS Corporation
CVX	ChevronTexaco Corporation
CW	Curtiss-Wright Corporation
CWF	Chartwell Dividend and Income Fund Inc.
CWT	California Water  Service Group Holding
CWZ	Lehman Abs Corporation
CX	Cemex S.A.B. de C.V.
CXE	Colonial High Income Municipal Trust
CXG	CNX Gas Corporation
CXH	Colonial Investment Grade Municipal Trust
CXO	Concho Resources Inc.
CXR	Cox Radio Inc.
CXW	Corrections Corporation of America
CY	Cypress Semiconductor Corporation
CYD	China Yuchai International
CYE	Blackrock Corporate High Yield Fund III Inc
CYH	Community Health Systems Inc.
CYN	City National Corporation
CYP	Lehman Abs Corporation
CYT	Cytec Industries Inc.
CZZ	Cosan
D	Dominion Resources Inc.
DAC	Danaos Corporation
DAI	Daimler AG
DAL	Delta Air Lines Inc. (New)
DAN	Dana Holding Corporation
DAR	Darling International Inc.
DB	Deutsche Bank AG
DBD	Diebold Incorporated
DCA	Dividend Capital Realty Income Allocation Fund
DCE	Deutsche Bk Cap Fdg Tr X
DCI	Donaldson Company Inc.
DCM	Ntt Docomo Inc
DCO	Ducommun Incorporated
DCP	Dyncorp International Inc.
DCS	Dreman/Claymore Dividend & Income Fund
DCT	DCT Industrial Trust Inc
DCW	Dividend Capital Global Realty Exposure Fund
DD	E.I. du Pont de Nemours and Company
DD-A	E.I. du Pont de Nemours and Company
DD-B	E.I. du Pont de Nemours and Company
DDE	Dover Downs Gaming & Entertainment Inc
DDF	Delaware Investments Dividend & Income Fund Inc.
DDR	Developers Diversified Realty Corporation
DDR-G	Developers Diversified Realty Corporation
DDR-H	Developers Diversified Realty Corporation
DDR-I	Developers Diversified Realty Corporation
DDS	Dillard's Inc.
DDT	Dillard's Inc.
DE	Deere & Company
DEG	Etablissements Delhaize Freres Et Cie Le Lion S.a.
DEI	Douglas Emmett Inc.
DEL	Deltic Timber Corporation
DEO	Diageo plc
DEP	Duncan Energy Partners L.P.
DEX	Delaware Enhanced Global Dividend
DF	Dean Foods Company
DFG	Delphi Financial Group Inc.
DFP	Delphi Financial Group Inc.
DFS	Discover Financial Services
DFT	Dupont Fabros Technology Inc.
DFY	Delphi Financial Group Inc.
DGF	Delaware Investments Global Dividend & Income Fund Inc.
DGX	Quest Diagnostics Incorporated
DHF	Dreyfus High Yield Strategies Fund
DHG	DWS Dreman Value Income Edge Fund Inc.
DHI	D.R. Horton Inc.
DHM	Structured Obligations Corp 8.125 Cobalts
DHR	Danaher Corporation
DHT	DHT Maritime Inc.
DHX	Dice Holdings Inc.
DIN	DineEquity Inc
DIS	Walt Disney Company (the)
DK	Delek US Holdings Inc.
DKC	Ms Structured Asset Corp Saturns Ge Cap Corp Series 2002-14
DKF	Ms Structured Asset Corp Saturns Ge Cap Corp Series 2002-14
DKI	Ms Structured Asset Corp Saturns Ge Cap Corp Series 2002-14
DKK	Lehman Abs Corporation
DKL	Lehman Abs Corporation
DKM	Ms Structured Asset Corp Saturns Ge Cap Corp Series 2002-14
DKP	Ms Structured Asset Corp Saturns Ge Cap Corp Series 2002-14
DKQ	Ms Structured Asset Corp Saturns Ge Cap Corp Series 2002-14
DKR	Ms Structured Asset Corp Saturns Ge Cap Corp Series 2002-14
DKS	Dick's Sporting Goods Inc
DKT	Deutsch Bk Contingent Cap Tr V
DKW	Ms Structured Asset Corp Saturns Ge Cap Corp Series 2002-14
DKX	Ms Structured Asset Corp Saturns Ge Cap Corp Series 2002-14
DKY	Ms Structured Asset Corp Saturns Ge Cap Corp Series 2002-14
DLB	Dolby Laboratories
DLM	Del Monte Foods Company
DLR	Digital Realty Trust Inc.
DLR-A	Digital Realty Trust Inc.
DLR-B	Digital Realty Trust Inc.
DLX	Deluxe Corporation
DM	Dolan Media Company
DNA	Genentech, Inc.
DNB	Dun & Bradstreet Corporation (The)
DNP	Duff & Phelps Utilities Income Inc.
DNR	Denbury Resources Inc. (Holding Company)
DNY	R.R. Donnelley & Sons Co
DO	Diamond Offshore Drilling Inc.
DOM	Dominion Resources Black Warrior Trust
DOV	Dover Corporation
DOW	Dow Chemical Company (The)
DOX	Amdocs
DPD	Dow 30 Premium
DPL	DPL Inc.
DPM	DCP Midstream Partners LP
DPO	Dow 30 Premium
DPS	Dr Pepper Snapple Group Inc
DPZ	Domino's Pizza Inc
DRC	Dresser-Rand Group Inc.
DRE	Duke Realty Corporation
DRE-J	Duke Realty Corporation
DRE-K	Duke Realty Corporation
DRE-L	Duke Realty Corporation
DRE-M	Duke Realty Corporation
DRE-N	Duke Realty Corporation
DRE-O	Duke Realty Corporation
DRH	Diamondrock Hospitality Company
DRI	Darden Restaurants Inc.
DRL	Doral Financial Corporation
DRP	DWS Rreef World Estate & Tactical Strategies Fund Inc.
DRQ	Dril-Quip Inc.
DSF	Defined Strategy Fund Inc.
DSM	Dreyfus Strategic Municipal Bond Fund Inc.
DST	DST Systems Inc.
DSU	Blackrock Debt Strategies Fund Inc.
DSW	DSW Inc.
DSX	Diana Shipping inc.
DT	Deutsche Telekom AG
DTE	DTE Energy Company
DTE-A	DTE Energy Company
DTE-C	DTE Energy Company
DTF	Duff & Phelps Utilities Tax-Free Income Inc.
DTG	Dollar Thrifty Automotive Group Inc.
DTK	Deutsche Bank AG
DTT	Deutsche Bank Cap Fdg Tr IX
DUA	Deutsche Bank Cap Fdg Tr VIII
DUC	Duff & Phelps Utility & Corporate Bond Trust Inc.
DUF	Duff & Phelps Corporation
DUK	Duke Energy Corporation
DV	DeVry Inc.
DVA	DaVita Inc.
DVD	Dover Downs Entertainment Inc.
DVF	Blackrock Diversified Income Strategies Fund Inc.
DVM	Cohen & Steers Dividend Majors Fund
DVN	Devon Energy Corporation
DVR	Cal Dive International Inc.
DW	Drew Industries Incorporated
DWA	Dreamworks Animation SKG Inc.
DX	Dynex Capital Inc.
DX-D	Dynex Capital Inc.
DXB	Deutsche Bank AG
DY	Dycom Industries Inc.
DYN	Dynegy Inc.
DYS	Distribucion y Servicio
E	ENI S.p.A.
EAC	Encore Acquisition Company
EAT	Brinker International Inc.
EBF	Ennis Inc.
EBI	Evergreen International Balanced Income Fund
EBR	CENTRAIS ELETRICAS BRASILEIRAS
EBR.B	CENTRAIS ELETRICAS BRASILEIRAS
EBS	Emergent Biosolutions Inc.
EC	Engelhard Corporation
ECA	Encana Corporation
ECL	Ecolab Inc.
ED	Consolidated Edison Inc.
ED-A	Consolidated Edison Inc.
ED-C	Consolidated Edison Inc.
EDD	MORGAN STANLEY EMERGING MKTS D
EDE	Empire District Electric Company (The)
EDE-D	Empire District Electric Company (The)
EDN	Empresa Nacional de Electricidad S.A.
EDR	Education Realty Trust Inc.
EDU	New Oriental Education & Technology Group, Inc.
EE	El Paso Electric Company
EEA	European Equity Fund, Inc. (the)
EEP	Enbridge Energy Partnership
EEQ	Enbridge Energy Management LLC
EFL	Western Asset Emerging Markets Floating Rate Fund, Inc.
EFR	Eaton Vance Senior Floating-Rate Fund
EFT	Eaton Vance Floating Rate Income Trust
EFX	Equifax Inc.
EGF	Blackrock Enhanced Government Fund Inc
EGN	Energen Corporation
EGP	EastGroup Properties Inc.
EGY	Vaalco Energy Inc
EHA	Entergy Arkansas Inc.
EHB	Entergy Arkansas Inc.
EHI	Western Asset Global High Income Fund Inc
EHL	Entergy Louisiana Inc.
EIG	Employers Holdings Inc
EIX	Edison International
EJ	E-House (China) Holdings
EK	Eastman Kodak Company
EL	Estee Lauder Companies Inc. (The)
ELN	Elan Corporation plc
ELP	Companhia Paranaense de Energia (COPEL)
ELS	Equity Lifestyle Properties Inc.
ELX	Emulex Corporation
ELY	Callaway Golf Company
EMC	EMC Corporation
EMD	Western Asset Emerging Markets Income Fund, Inc
EME	EMCOR Group Inc.
EMF	Templeton Emerging Markets Fund
EMN	Eastman Chemical Company
EMO	Entergy Mississippi Inc.
EMQ	Entergy Mississippi Inc.
EMR	Emerson Electric Company
EMS	Emergency Medical Services Corporation
ENB	Enbridge Inc
ENH	Endurance Specialty Holdings Ltd
ENH-A	Endurance Specialty Holdings Ltd
ENI	Enersis S A
ENL	Reed Elsevier Nv
ENP	Encore Energy Partners LP
ENR	Energizer Holdings Inc.
ENS	Enersys
ENT	Enterra Energy Trust
ENZ	Enzo Biochem Inc.
EOC	Empresa Nacional de Electricidad S.A.
EOD	EVERGREEN GLOBAL DIVIDEND OPPO
EOE	Eaton Vance Credit Opportunities Fund
EOG	EOG Resources Inc.
EOI	Eaton Vance Enhance Equity Income Fund
EOS	Eaton Vance Enhanced Equity Income Fund II
EP	El Paso Corporation
EP-C	El Paso Corporation
EPB	El Paso Pipeline Partners LP
EPD	Enterprise Products Partners L.P.
EPE	Enterprise GP Holdings L.P.
EPL	Energy Partners Ltd.
EPR	Entertainment Properties Trust
EPR-B	Entertainment Properties Trust
EPR-C	Entertainment Properties Trust
EPR-D	Entertainment Properties Trust
EPR-E	Entertainment Properties Trust
EQ	Embarq Corporation
EQR	Equity Residential
EQR-E	Equity Residential
EQR-H	Equity Residential
EQR-N	Equity Residential
EQS	Equus Total Return Inc.
EQT	Equitable Resources Inc.
EQY	Equity One Inc.
ERF	Enerplus Resources Fund
ERJ	Embraer-Empresa Brasileira de Aeronautica
ES	EnergySolutions Inc
ESC	EMERITUS CP
ESD	Western Asset Emerging Markets Debt Fund Inc
ESE	ESCO Technologies Inc.
ESI	Itt Educational Services, Inc.
ESL	Esterline Technologies Corporation
ESS	Essex Property Trust Inc.
ESV	ECO International Incorporated
ETB	Eaton Vance Tax-Managed Buy-Write Income Fund
ETE	ENERGY TRAFER PARTNERS
ETG	Eaton Vance Tax-Advantaged Global Dividend Income Fund
ETH	Ethan Allen Interiors Inc.
ETJ	Eaton Vance Risk-Managed Diversified Equity Income Fund
ETM	Entercom Communications Corporation
ETN	Eaton Corporation
ETO	Eaton Vance Tax-Advantage Global Dividend Opp
ETP	ENERGY TRAFER PARTNERS
ETR	Entergy Corporation
ETR-A	Entergy Corporation
ETV	Eaton Vance Corporation
ETW	Eaton Vance Corporation
ETY	Eaton Vance Tax-Managed Diversified Equity Income Fund
EV	Eaton Vance Corporation
EVC	Entravision Communications Corporation
EVF	Eaton Vance Senior Income Trust
EVG	Eaton Vance Short Diversified Income Fund
EVN	Eaton Vance Municipal Income Trust
EVR	Evercore Partners Inc
EVT	Eaton Vance Tax Advantaged Dividend Income Fund
EW	Edwards Lifesciences Corporation
EXC	Exelon Corporation
EXG	Eaton Vance Tax-Managed Global Diversified Equity Income Fund
EXH	EXTERRAN HOLDINGS INC.
EXM	Excel Maritime Carriers, Ltd.
EXP	Eagle Materials Inc
EXR	Extra Space Storage Inc
EYE	Advanced Medical Optics Inc.
F	Ford Motor Credit Company
F-A	Ford Mtr Co Del
F-S	Ford Mtr Co Cap Tr Ii
FA	Fairchild Corporation (the)
FAC	Liberte Investors Inc.
FAF	First American Corporation (the)
FAM	First Trust/aberdeen Global Opportunity Income Fund
FAV	FIRST TRUST ACTIVE DIVIDEND IN
FBC	Flagstar Bancorp, Inc.
FBF-M	Fleet Cap Tr Viii
FBF-N	Fleet Cap Tr Ix
FBN	Furniture Brands International, Inc.
FBP	First Bancorp.
FBP-A	First Bancorp P R
FBP-B	First Bancorp P R
FBP-C	First Bancorp P R
FBP-D	First Bancorp P R
FBP-E	First Bancorp P R
FBR	Friedman, Billings, Ramsey Group, Inc.
FBS-A	First Pfd Cap Tr Iv
FC	Franklin Covey Company
FCE.A	Forest City Enterprises Inc
FCE.B	Forest City Enterprises Inc
FCF	First Commonwealth Financial Corporation
FCH	Felcor Lodging Trust Incorporated
FCH-A	Felcor Lodging Tr Inc
FCH-C	Felcor Lodging Tr Inc
FCJ	Ford Motor Credit Company
FCL	Foundation Coal Holdings, Inc.
FCN	Fti Consulting, Inc.
FCS	Fairchild Semiconductor International, Inc.
FCT	First Trust Four Corners Senior
FCX	Freeport-mcmoran Copper & Gold, Inc.
FCX-M	FREEPORT-MCMORAN COPPER &     GO
FCY	Forest City Enterprises Inc
FCZ	Ford Motor Credit Company
FDI	Fort Dearborn Income Securities, Inc.
FDO	Family Dollar Stores, Inc.
FDP	Fresh Del Monte Produce, Inc.
FDS	Factset Research Systems Inc.
FDX	Fedex Corporation
FE	Firstenergy Corporation
FED	Firstfed Financial Corporation
FEO	First Trust/aberdeen Emerging Opportunity Fund
FF	First Financial Fund, Inc.
FFA	First Trust/fiduciary
FFC	Flaherty & Crumrine/claymore Preferred Securities Income Fd In
FFD	MORGAN STANLEY FRONTIER EMERGI
FFG	Fbl Financial Group, Inc.
FFH	Fairfax Financial Holdings Ltd
FGB	FIRST TRUST/GALLITIN SPECIALTY
FGC	Fpl Group Capital Inc
FGE	FPL GROUP CAPITAL INC
FGF	Sunamerica, Inc.
FGI	Sunamerica, Inc.
FGP	Ferrellgas Partners, L.p.
FHI	First Trust
FHN	First Tennessee National Corporation
FHO	FIRST TRUST STRATEGIC HIGH INC
FHY	First Trust Strategic High Income Fund Ii
FIC	Fair, Isaac And Company, Incorporated
FIF	Financial Federal Corporation
FIG	Fortress Investment Group Llc
FII	Federated Investors, Inc.
FIS	Fidelity National Information Services, Inc.
FIX	Comfort Systems USA Inc.
FJA	MERRILL LYNCH DEPOSITOR INC SE
FL	Footlocker Inc
FLC	Flaherty & Crumrine/claymore Total Return Fund Inc
FLE	Fleetwood Enterprises, Inc.
FLO	Flowers Foods, Inc.
FLR	Fluor Corporation
FLS	Flowserve Corporation
FLY	Babcock & Brown Air
FMC	Fmc Corporation
FMD	First Marblehead Corporation (the)
FMN	Federated Premier Municipal Income Fund
FMO	Fiduciary/claymore Mlp Opportunity Fund
FMR	First Mercury Financial Corporation
FMS	Fresenius Medical Care Corporation
FMS.P	FRESENIUS MEDICAL CARE AG PFD
FMX	Fomento Economico Mexicano S.a.b. De C.v.
FMY	First Trust
FNA	FANNIE MAE 8.75 PFD
FNB	F.n.b. Corporation
FNF	Fidelity National Financial, Inc.
FNM	Federal National Mortgage Association
FNM-F	Federal Natl Mtg Assn
FNM-G	Federal Natl Mtg Assn
FNM-H	Federal Natl Mtg Assn
FNM-I	Federal Natl Mtg Assn
FNM-L	Federal Natl Mtg Assn
FNM-M	Federal Natl Mtg Assn
FNM-N	Federal Natl Mtg Assn
FNM-P	FEDERAL NATL MTG PFD
FNM-Q	FANNIE MAE
FNM-R	FANNIE MAE
FNM-S	FANNIE MAE 8.25% SERIES S
FNM-T	FANNIE MAE 8.25%
FO	Fortune Brands, Inc.
FOE	Ferro Corporation
FOF	Cohen & Steers Closed-End Opportunity Fund Inc.
FOR	FORESTAR REAL ESTATE GROUP INC
FPC-A	Fpc Cap I
FPL	Fpl Group, Inc.
FPL-C	Fpl Group Cap Tr I
FPO	First Potomac Realty Trust
FPT	Federated Premier Intermediate Municipal Income Fund
FR	First Industrial Realty Trust, Inc.
FR-J	First Industrial Realty Trus
FR-K	First Industrial Realty Trus
FRA	Blackrock Floating Rate Income Strategies Fund Inc
FRB	Blackrock Floating Rate Income Strategies Fund II Inc
FRE	Federal Home Loan Mortgage Corporation
FRE-B	Federal Home Ln Mtg Corp
FRE-F	Federal Home Ln Mtg Corp
FRE-G	Federal Home Ln Mtg Corp
FRE-H	Federal Home Ln Mtg Corp
FRE-K	Federal Home Ln Mtg Corp
FRE-L	Federal Home Ln Mtg Corp
FRE-M	Federal Home Ln Mtg Corp
FRE-N	Federal Home Ln Mtg Corp
FRE-O	Federal Home Ln Mtg Corp
FRE-P	Federal Home Ln Mtg Corp
FRE-Q	Federal Home Ln Mtg Corp
FRE-R	Federal Home Ln Mtg Corp
FRE-S	Federal Home Ln Mtg Corp
FRE-T	Federal Home Ln Mtg Corp
FRE-U	Federal Home Ln Mtg Corp
FRE-V	Federal Home Ln Mtg Corp
FRE-W	FREDDIE MAC
FRE-X	FREDDIE MAC 6.02%
FRE-Y	FREDDIE MAC
FRE-Z	FREDDIE MAC $1.00 PAR VALUE
FRM	FRIEDMA INC
FRO	Frontline Ltd.
FRP	Fairpoint Communications, Inc.
FRT	Federal Realty Investment Trust
FRX	Forest Laboratories, Inc.
FRZ	Reddy Ice Holdings, Inc.
FSB	Financial Security Assurance Holdings Ltd
FSC	FIFTH STREET FINANCE CORP
FSE	Financial Security Assurance Holdings Ltd
FSF	Financial Security Assurance Holdings Ltd
FSR	FLAGSTONE REIURANCE HOLDINGS
FSS	Federal Signal Corporation
FST	Forest Oil Corporation
FT	Franklin Universal Trust
FTB-A	FIFTH THIRD CAPITAL TRUST V
FTB-B	FIFTH THIRD CAPITAL TRUST VI
FTB-C	FIFTH THIRD CAPITAL TRUST VII
FTE	France Telecom S.a.
FTI	Fmc Technologies, Inc.
FTK	FLOTEK INDS INC [DE]
FTO	Frontier Oil Corporation
FTR	FRONTIER COMM CORP
FUL	H. B. Fuller Company
FUN	Cedar Fair L.P.
FUR	First Union Real Estate Equity And Mortgage Investments
FWF	WELLS FARGO CAPITAL XI
G	Gillette Company (The)
GA	GIANT INTERACTIVE GROUP INC
GAB	Gabelli Equity Trust, Inc. (the)
GAB-D	Gabelli Equity Tr Inc
GAB-F	Gabelli Equity Tr Inc
GAH	Georgia Power Company
GAJ	Great Atlantic & Pacific Tea Company, Inc. (the)
GAM	General American Investors, Inc.
GAM-B	General Amern Invs Inc
GAP	Great Atlantic & Pacific Tea Company, Inc. (the)
GAR	GEORGIA POWER CO. SERIES
GAS	Nicor Inc.
GAT	GEORGIA POWER COMPANY 8.20%
GB	Wilson Greatbatch Technologies, Inc.
GBE	Grubb
GBL	Gabelli Asset Management Inc.
GBM	General Motors Corporation
GBX	Greenbrier Companies, Inc. (the)
GCA	Global Cash Access Holdings, Inc.
GCF	Global Income & Currency Fund Inc.
GCH	Greater China Fund, Inc.
GCI	Gannett Co., Inc.
GCO	Genesco Inc.
GCS	Scudder Global Commodities Stock Fund Inc
GCV	Gabelli Convertible And Income Securities Fund, Inc. (the)
GCV-B	Gabelli Conv & Income Secs F
GD	General Dynamics Corporation
GDF	Western Asset Global Partners Income Fund, Inc.
GDI	Gardner Denver, Inc.
GDL	The Gabelli Global Deal Fund
GDL-A	T
GDP	Goodrich Petroleum Corporation
GDV	Gabelli Dividend
GDV-A	Gabelli Divd & Income Tr
GDV-D	Gabelli Divd & Income Tr
GE	General Electric Company
GE-A	GENERAL ELECTRIC CAPITAL CORPO
GEA	General Electric Capital Corporation
GEC	General Electric Capital Corporation
GED	General Electric Capital Corporation
GEF	Greif Bros. Corporation
GEF.B	Greif Inc
GEG	Global Power Equipment Group Inc.
GEJ	GENERAL ELECTRIC CAPITAL CORP
GEO	Geo Group Inc (the)
GEP	General Electric Capital Corporation
GER	General Electric Capital Corporation
GES	Guess?, Inc.
GET	Gaylord Entertainment Company
GF	New Germany Fund, Inc. (the)
GFA	GAFISA S.A
GFF	Griffon Corporation
GFG	GUARANTY FINANCIAL GROUP INC
GFI	Gold Fields Ltd.
GFW	AAG Holding Company Inc.
GFY	Western Asset Variable Rate Strategic Fund Inc.
GFZ	AAG Holding Company Inc.
GG	Goldcorp Incorporated
GG.W	GOLDCORP INC. SERIES C WARRANTS
GGB	Gerdau S.a.
GGC	Georgia Gulf Corporation
GGG	Graco Inc.
GGP	General Growth Properties, Inc.
GGT	Gabelli Global Multi-media Trust, Inc. (the)
GGT-B	Gabelli Global Multimedia Tr
GHI	Global High Income Dollar Fund, Inc.
GHL	Greenhill
GIB	CGI Group Inc.
GIL	Gildan Activewear, Inc.
GIM	Templeton Global Income Fund, Inc.
GIS	General Mills, Inc.
GJB	Strats Tr For Bellsouth Telecommunications Ctfs
GJD	Strats Tr For Bellsouth Telecommunications Ctfs
GJE	Strats Tr For Bellsouth Telecommunications Ctfs
GJF	Strats Tr For Bellsouth Telecommunications Ctfs
GJG	Strats Tr For Bellsouth Telecommunications Ctfs
GJH	Strats Tr For Bellsouth Telecommunications Ctfs
GJI	Strats Tr For Bellsouth Telecommunications Ctfs
GJJ	Strats Tr For Bellsouth Telecommunications Ctfs
GJK	Strats Tr For Bellsouth Telecommunications Ctfs
GJL	Strats Tr For Bellsouth Telecommunications Ctfs
GJM	Gmac Llc
GJN	Floating Rate Structured Repackaged Asset-backed Trust
GJO	Synthetic Fixed-income Securities, Inc.
GJP	Synthetic Fixed-income Securities, Inc.
GJR	Synthetic Fixed-income Securities, Inc.
GJS	Goldman Sachs Group Securities
GJT	Synthetic Fixed-income Securities, Inc.
GJV	Synthetic Fixed-income Securities Inc
GJW	SYNTHETIC FIXED INCOME SECURIT
GJX	SYNTHETIC FIXED INCOME SECURIT
GKK	Gramercy Capital Corp
GKK-A	GRAMERCY CAPITAL CORP 8.125%
GKM	Gmac Llc
GLF	GULFMARK OFFSHORE INC
GLG	Glamis Gold Ltd.
GLG.U	GLG PARTNERS UTS
GLG.W	GLG PARTNERS WTS
GLP	Global Partners Lp
GLS	Genesis Lease
GLT	Glatfelter
GLW	Corning Incorporated
GM	General Motors Corporation
GMA	Gmac Llc
GME	Gamestop Corporation
GMK	Gruma, S.a. De C.v.
GMR	General Maritime Corporation
GMS	General Motors Corporation
GMT	Gatx Corporation
GMW	General Motors Corporation
GNA	Gerdau Ameristeel
GNI	Great Northern Iron Ore Properties
GNK	GENCO SHIPPING & TRADIN    G LIM
GNV	GSC INVESTMENT CORP
GNW	Genworth Financial Inc
GOF	Claymore/Guggenheim Strategic Opportunities Fund
GOL	Gol Linhas Aereas Inteligentes S.a.
GOM	Gmac Llc
GPC	Genuine Parts Company
GPD	Georgia Power Company
GPE-A	Georgia Pwr Co
GPE-X	Georgia Pwr Cap Tr Vii
GPI	Group 1 Automotive, Inc.
GPJ	Georgia Power Company
GPK	Graphic Packaging International Corporation
GPM	General Motors Corporation
GPN	Global Payments Inc.
GPS	Gap, Inc. (the)
GPU	Georgia Power Company
GPW	Georgia Power Company
GPX	Gp Strategies Corporation
GR	Goodrich Corporation (the)
GRA	W.r. Grace & Company
GRB	Gerber Scientific, Inc.
GRE	S&p 500 Geared Fund Inc.
GRM	GENERAL MOTORS CORPORATION
GRO	Agria Corporation
GRR	Asia Tigers Fund Inc. (The)
GRS	GAMMON GOLD INC
GRT	Glimcher Realty Trust
GRT-F	Glimcher Rlty Tr
GRT-G	Glimcher Rlty Tr
GRX	THE GABELLI HEALTHCARE &     WEL
GS	Goldman Sachs Group, Inc. (the)
GS-A	Goldman Sachs Group Inc
GS-B	Goldman Sachs Group Inc
GS-C	Goldman Sachs Group Inc
GS-D	Goldman Sachs Group Inc
GSH	Guangshen Railway Company
GSI	GENERAL STEEL HLDGS
GSK	Glaxosmithkline Plc
GSL	Global Signal Inc
GSL.U	GLOBAL SHIP LEASE UT
GSL.W	GLOBAL SHIP LEASE WT
GT	Goodyear Tire & Rubber Company (the)
GTI	Graftech International Ltd
GTN	Gray Television, Inc.
GTN.A	Gray Television Inc
GTS	TRIPLE-S MANAGEMENT CORPORATIO
GTY	Getty Realty Corporation
GU	GUSHMAN ENVIRONMENTAL ENERGY L
GUI	Gulf Power Company
GUL	Gulf Power Company
GUQ	Gulf Power Company
GUT	Gabelli Utility Trust (the)
GUT-A	Gabelli Util Tr
GVA	Granite Construction Incorporated
GWF	Wells Fargo & Company
GWR	Genesee & Wyoming, Inc.
GWW	W.w. Grainger, Inc.
GXM	General Motors Corporation
GXP	Great Plains Energy Inc
GXP-A	Great Plains Energy Inc
GXP-D	Great Plains Energy Inc
GXP-E	Great Plains Energy Inc
GY	Gencorp Inc.
GYA	Corporate Asset Backed Corp CABCO
GYB	CABCO Series 2004-101 Trust
GYC	Corporate Asset Backed Corp CABCO
HAE	Haemonetics Corporation
HAL	Halliburton Company
HAR	Harman International Industries, Incorporated
HAS	Hasbro, Inc.
HAV	HELIOS ADVANTAGE INCOME FUND
HBA-D	Hsbc Usa Inc New
HBA-F	Hsbc Usa Inc New
HBA-G	Hsbc Usa Inc New
HBA-H	Hsbc Usa Inc New
HBA-Z	Hsbc Usa Inc New
HBC	Hsbc Holdings, Plc.
HBC-A	Hsbc Hldgs Plc
HBC.P	HARRIS PREFERRED CAP CP PFD
HBI	Hanesbrands Inc.
HCC	Hcc Insurance Holdings, Inc.
HCD	Highland Distressed Opportunities, Inc.
HCE	Fiduciary/claymore Dynamic Equity Fund
HCF	Highland Credit Stategies Fund
HCH	Merrill Lynch Canada Inc Cp Holdrs
HCN	Health Care Reit, Inc.
HCN-D	Health Care Reit Inc
HCN-F	Health Care Reit Inc
HCN-G	Health Care Reit Inc
HCP	Health Care Property Investors, Inc.
HCP-E	Health Care Ppty Invs Inc
HCP-F	Health Care Ppty Invs Inc
HCS	HSBC HOLDING PLC
HD	Home Depot, Inc. (the)
HDB	Hdfc Bank
HE	Hawaiian Electric Industries, Inc.
HE-U	Heco Cap Tr Iii
HEI	Heico Corporation
HEI.A	Heico Corporation
HEK	HECKMANN CORPORATION
HEK.U	HECKMANN CORP UTS
HEK.W	HECKMANN CORP WTS
HEP	Holly Energy Partners, L.p.
HES	Hess Corporation
HEW	Hewitt Associates Inc
HF	Hff, Inc.
HFC-B	Hsbc Finance Corp
HGG	HHGREGG INC
HGM	General Motors Corporation
HGR	Hanger Orthopedic Group, Inc.
HGT	Hugoton Royalty Trust
HHS	Harte-hanks, Inc.
HI	HILLENBRAND INC
HIF	Western Asset High Income Fund Inc.
HIG	Hartford Financial Services Group, Inc. (the)
HIH	Highland Hospitality Corporation
HIL	HILL INTERNATIONAL INC
HIO	Western Asset High Income Opportunity Fund, Inc.
HIS	CIGNA High Income
HIT	Hitachi, Ltd.
HIW	Highwoods Properties, Inc.
HIW-B	Highwoods Pptys Inc
HIX	Western Asset High Income Fund Ii Inc.
HJA	Ms Structured Asset Corp Saturns Ge Cap Corp Series 2002-14
HJE	Ms Structured Asset Corp Saturns Ge Cap Corp Series 2002-14
HJG	Ms Structured Asset Corp Saturns Ge Cap Corp Series 2002-14
HJJ	Ms Structured Asset Corp Saturns Goldman Sachs
HJL	Ms Structured Asset Corp Saturns Ge Cap Corp Series 2002-14
HJN	Ms Structured Asset Corp Saturns Ge Cap Corp Series 2002-14
HJO	Ms Structured Asset Corp Saturns Ge Cap Corp Series 2002-14
HJR	Ms Structured Asset Corp.
HJT	Ms Structured Asset Corp
HJV	MS STRUCTURED ASSET CORP. SATU
HK	PETROHAWK ENERGY CORPORATION
HL	Hecla Mining Company
HL-B	Hecla Mng Co
HL-C	HECLA MINING COMPANY 6.5%
HLF	Herbalife Ltd.
HLS	Healthsouth Corporation
HLX	Helix Energy Solutions Group Inc
HMA	Health Management Associates, Inc.
HMC	Honda Motor Company, Ltd.
HME	Home Properties, Inc.
HMH	HELLOS MULTI-SECTOR HIHG INCOM
HMN	Horace Mann Educators Corporation
HMY	Harmony Gold Mining Co. Ltd.
HNI	Hon Industries Inc.
HNP	Huaneng Power Intl
HNR	Benton Oil and Gas Company
HNT	Health Net Inc.
HNZ	Heinz H J Co
HOC	Holly Corporation
HOG	Harley-davidson, Inc.
HON	Honeywell International Inc.
HOO	Cascal N.V.
HOS	Hornbeck Offshore Services
HOT	Starwood Hotels & Resorts Worldwide, Inc.
HOV	Hovnanian Enterprises Inc
HP	Helmerich & Payne, Inc.
HPF	John Hancock Pfd Income Fund Ii
HPI	John Hancock Preferred Income Fund
HPQ	Hewlett-packard Company
HPS	John Hancock Preferred Income Fund Iii
HPT	Hospitality Properites Trust
HPT-B	Hospitality Pptys Tr
HPT-C	HOSPITALITY PROPERTIES TRUST
HPY	Heartland Payment Systems, Inc.
HQH	H&q Healthcare Investors
HQL	H&q Life Sciences Investors
HR	Healthcare Realty Trust Incorporated
HRB	H&r Block, Inc.
HRC	HILL ROM HOLDINGS INC
HRL	Hormel Foods Corporation
HRP	Hrpt Properties Trust
HRP-B	Hrpt Pptys Tr
HRP-C	Hrpt Pptys Tr
HRP-D	Hrpt Pptys Tr
HRS	Harris Corporation
HRZ	Horizon Lines, Inc.
HS	Healthspring, Inc.
HSA	HELIOS STRATEGIC INCOME FUND
HSC	Harsco Corporation
HSF	Hartford Income Fund Inc
HSM	Hyperion Strategic Mortgage Income Fund (the)
HSP	Hospira Inc
HST	Host Marriott Financial Trust
HST-E	Host Hotels & Resorts Inc
HSY	Hershey Foods Corporation
HT	HERSHA HOSPITALITY
HT-A	HERSHA HOSP TR PR A
HTB	Household Finance Corp
HTD	John Hancock Tax Advantaged Dividend Income Fund
HTE	Harvest Energy Trust
HTH	HILLTOP HOLDINGS INC
HTH-A	HILLTOP HOLDINGS INC
HTN	Household Finance Corp
HTR	Hyperion Total Return Fund, Inc. (the)
HTS	HATTERAS FINANCIAL CORP
HTV	Hearst-argyle Television, Inc.
HTX	Hutchison Telecommunications International
HTY	JOHN HANCOCK TAX ADV GLOBAL SH
HTZ	Hertz Global Holdings, Inc
HUB.A	Hubbell Inc A
HUB.B	Hubbell Inc A
HUM	Humana Inc.
HUN	Huntsman Corporation
HVT	Haverty Furniture Companies, Inc.
HVT.A	Haverty Furniture Companies, Inc.
HW	Headwaters Incorporated
HWD	HARRY WINSTON DIAMOND CORP
HXL	Hexcel Corporation
HXM	Desarrolladora Homex
HYA	Lehman Abs Corporation
HYB	New America High Income Fund, Inc. (the)
HYC	Hypercom Corporation
HYF	Managed High Yield Plus Fund, Inc.
HYH	Lehman Abs Corporation
HYI	High Yield Income Fund, Inc. (the)
HYJ	Lehman Abs Corporation
HYK	Lehman Abs Corporation
HYL	Lehman Abs Corporation
HYM	Lehman Abs Corporation
HYP	High Yield Plus Fund, Inc. (the)
HYT	Blackrock Corporate High Yield Fund VI Inc
HYV	Blackrock Corporate High Yield Fund V Inc
HYY	Structured Products Corp 6.25 Verizon Gbl
HZD	Structured Products Corp.
HZK	Structured Products Corp.
HZO	Marinemax, Inc.
IAE	ING ASIA PACIFIC HIGH DIVIDEND
IAG	Iamgold Corporation
IBA	Industrias Bachoco, S.a. De C.v.
IBI	Interline Brands, Inc.
IBM	International Business Machines Corporation
IBN	Icici Bank
ICA	Empresas Ica Soc Contrladora
ICB	Ms Income Securities, Inc.
ICE	Intercontinental Exchange, Inc.
ICO	International Coal Group, Inc.
ICS	Ms Insured California Municipal Securities
ID	L-1 Identity Solutions, Inc.
IDA	Idacorp, Inc.
IDC	Interactive Data Corporation
IDG	INDUSTRIAL DISTR GRP INC
IDT	Idt Corporation
IDT.C	Idt Corp
IEP	ICAHN ENTERPRISES LP
IEP.P	ICAHN ENTERPRISE PFD
IEX	Idex Corporation
IFC	Irwin Financial Corporation
IFC-M	Ifc Cap Tr Vi
IFF	Internationa Flavors & Fragrances, Inc.
IFN	India Fund, Inc. (the)
IFX	Infineon Technologies Ag
IGA	Ing Global Advantage And Premium Opportunity Fund
IGD	Ing Global Equity Dividend And Premium Opportunity Fund
IGK	ING GROEP NV
IGR	ING CLARION GLBL RE
IGT	International Game Technology
IHC	Independence Holding Company
IHG	Intercontinental Hotels Group
IHR	Meristar Hotels & Resorts, Inc.
IHS	Ihs Inc.
IIA	ING CLARION REIF
IIC	Ms California Insured Municipal Income Trust
IID	ING INTL HIGH DIVIDEND EQTY IN
IIF	Morgan Stanley India Investment Fund, Inc.
IIM	Ms Insured Municipal Income Trust
IIT	Perusahaan Satlt Cp
IJD	Indiana Michigan Power Co.
IKJ	Bank of America Corporation
IKL	Bank of America Corporation
IKM	Bank of America Corporation
IKR	Bank of America Corporation
IM	Ingram Micro Inc.
IMA	INVERNESS MED INNOVA
IMA-B	INVERNESS MED PFD B
IMC	International Multifoods
IMF	Western Asset Inflation Management Fund Inc
IMN	Imation Corporation
IMP	Itla Capital Corporation
IMS	Ms Insured Municipal Securities
IMT	Ms Insured Municipal Trust
IN	Unova, Inc.
INB	Cohen & Steers Global Income Builder Inc.
IND	Ing Group, N.v.
ING	Ing Group, N.v.
INT	World Fuel Services Corporation
INZ	Ing Group, N.v.
IO	Input/output, Inc.
IP	International Paper Company
IPG	Interpublic Group Of Companies, Inc. (the)
IPI	INTREPID POTASH INC
IPL-B	Interstate Pwr & Lt Co
IPL-C	Interstate Pwr & Lt Co
IQC	Ms California Municipal Securities
IQI	Ms Quality Municipal Income Trust
IQM	Ms Quality Municipal Securities
IQN	Ms New York Quality Municipal Securities
IQT	Ms Quality Municipal Investment Trust
IR	Ingersoll-rand Company
IRC	Inland Real Estate Corporation
IRE	Governor And Company Of The Bank Of Ireland (the)
IRF	International Rectifier Corporation
IRL	Irish Investment Fund, Inc. (the)
IRM	Iron Mountain Incorporated
IRR	Ing Risk Managed Natural Resources Fund
IRS	Irsa Inversiones Y Representaciones S.a.
ISF	ING GROEP N.V
ISG	Ing Group, N.v.
ISH	International Shipholding Corporation
ISM	Slm Corporation
ISP	Ing Group, N.v.
IT	Gartner, Inc.
ITC	Itc Holdings Corp.
ITG	Investment Technology Group, Inc.
ITP	Intertape Polymer Group Inc.
ITT	Itt Industries, Inc.
ITU	Banco Itau Holding Financeira SA (Holding Co)
ITW	Illinois Tool Works Inc.
IVC	Invacare Corporation
IVN	Ivanhoe Mines Ltd
IVZ	INVESCO PLC
IWA	Iowa Telecommunications Services, Inc.
IX	Orix Corp Ads
JAH	Jarden Corporation
JAS	Jo-ann Stores, Inc.
JBI	Lehman Abs Cp 7.857%
JBJ	Lehman Abs Corporation
JBK	Lehman Abs Corporation
JBL	Jabil Circuit, Inc.
JBO	Lehman Abs Corporation
JBR	Select Asset Inc.
JBS	Select Asset Inc.
JBT	JOHN BEAN TECH CORP
JCE	NUVEEN CORE EQUITY ALPHA FUND
JCG	J. Crew Group, Inc.
JCI	Johnson Controls, Inc.
JCP	J.c. Penney Company, Inc. Holding Company
JDD	Nuveen Diversified Dividend And Income Fund
JEC	Jacobs Engineering Group Inc.
JEF	Jefferies Group, Inc.
JEQ	Japan Equity Fund, Inc. (the)
JFC	Jf China Region  Fund, Inc.
JFP	Nuveen Tax-advantaged Floating Rate Fund
JFR	Nuveen Floating Rate Income Fund
JGG	Nuveen Global Government Enhanced Income Fund
JGT	NUVEEN MULTI CURRENCY SHORT TE
JGV	Nuveen Global Value Opportunities Fund
JHI	John Hancock Investors Trust
JHP	Nuveen Quality Preferred Income Fund 3
JHS	John Hancock Income Securities Trust
JHX	James Hardie Industries Nv
JLA	Nuveen Equity Premium Advantage Fund
JLL	Jones Lang Lasalle Incorporated
JMP	JMP GROUP INC.
JNJ	Johnson & Johnson
JNS	Stilwell Financial Inc.
JNY	Jones Apparel Group, Inc.
JOE	St. Joe Company (the)
JOF	Japan Smaller Capitalization Fund Inc
JPC	Nuveen Preferred And Convertible Income Fund
JPG	Nuveen Equity Premium And Growth Fund
JPM	J.p. Morgan Chase & Co.
JPM-E	JPMORGAN CHASE & CO S    ER E
JPM-F	JPMORGAN CHASE & CO S    ER F
JPM-G	JPMORGAN CHASE & CO.
JPM-I	JPMORGAN CHASE & CO 8    .625%
JPM-J	Jp Morgan Chase Cap X
JPM-K	J P Morgan Chase Cap Xi
JPM-P	Jpmorgan Chase Cap Xvi
JPM-S	Jpmorgan Chase Cap Xix
JPM-W	JPMORGAN CHASE CAPITAL XXIV
JPM-X	J P Morgan Chase Cap Xii
JPM-Y	Jpmorgan Chase Cap Xiv
JPM-Z	JPMORGAN CHASE CAPITAL XXVI
JPS	Nuveen Quality Preferred Income Fund 2
JPZ	Nuveen Equity Premium Income Fund
JQC	Nuveen Preferred And Convertible Income Fund 2
JRN	Journal Communications, Inc.
JRO	Nuveen Floating Rate Income Opportuntiy Fund
JRT	Jer Investors Trust, Inc.
JSM	Slm Corporation
JSN	Nuveen Equity Premium Opportunity Fund
JTA	Nuveen Tax-advantaged Total Return Strategy Fund
JTD	NUVEEN TAX-ADVANTAGED DIVIDEND
JTP	Nuveen Quality Preferred Income Fund
JTX	Jackson Hewitt Tax Services
JW.A	John Wiley & Sons, Inc.
JW.B	John Wiley & Sons, Inc.
JWF	Wells Fargo & Company
JWN	Nordstrom, Inc.
JZC	Lehman Abs Corporation
JZE	Lehman Abs Corporation
JZH	Lehman Abs Corporation
JZJ	Lehman Abs Corporation
JZK	Lehman Abs Corporation
JZL	Lehman Abs Corporation
JZS	Lehman Abs Corporation
JZT	Lehman Abs Corp
JZV	Lehman Abs Corporation
K	Kellogg Company
KAI	Kadant Inc
KB	Kookmin Bank
KBH	Kb Home
KBR	Kbr, Inc.
KBW	Kbw Inc
KCC	Lehman Abs Corporation
KCI	Kinetic Concepts, Inc.
KCP	Kenneth Cole Productions, Inc.
KCT	Lehman Abs Corporation
KCW	Lehman Abs Corporation
KDE	4Kids Entertainment Inc.
KDN	Kaydon Corporation
KED	Kayne Anderson Energy Development Company
KEF	Korea Equity Fund, Inc.
KEG	Key Energy Services, Inc.
KEI	Keithley Instruments, Inc.
KEM	Kemet Corporation
KEP	Korea Electric Power Corporation
KEX	Kirby Corporation
KEY	Keycorp
KEY-A	Keycorp Cap V
KEY-B	Keycorp Cap Vi
KEY-D	Keycorp Capital Viii
KEY-E	Keycorp Cap Ix
KEY-F	KEYCORP CAPITAL X
KEY-G	KEYCORP PFD
KF	Korea Fund, Inc. (the)
KFN	Kkr Financial Corp.
KFS	Kingsway Financial Services, Inc.
KFT	Kraft Foods Inc.
KFY	Korn/ferry International
KG	King Pharmaceuticals, Inc.
KGC	Kinross Gold Corporation
KHD	KHD HUMBOLDT WEDAG INTERNATION
KHI	Scudder High Income Trust
KIM	Kimco Realty Corporation
KIM-F	Kimco Realty Corp
KIM-G	KIMCO REALTY CORPORATION
KKD	Krispy Kreme Doughnuts, Inc.
KMB	Kimberly-clark Corporation
KMM	Scudder Multi-market Income Trust
KMP	Kinder Morgan Energy Partners, L.p.
KMR	Kinder Morgan Management, Llc
KMT	Kennametal Inc.
KMX	CarMax Inc
KND	Kindred Healthcare, Inc.
KNL	Knoll, Inc.
KNM	Konami Corporation
KNO	Lehman Abs Corporation
KNR	Lehman Abs Corporation
KNX	Knight Transportation, Inc.
KO	Coca-Cola Company (The)
KOB	Lehman Abs Corporation
KOF	Coca Cola Femsa S.A.B. de C.V.
KOP	Koppers Holdings Inc.
KOS	Lehman Abs Corporation
KR	Kroger Company (the)
KRB-D	Mbna Cap D
KRB-E	Mbna Cap E
KRC	Kilroy Realty Corporation
KRC-E	Kilroy Rlty Corp
KRC-F	Kilroy Rlty Corp
KRG	Kite Realty Group Trust
KRH	Lehman Abs Corporation
KRJ	Lehman Abs Corporation
KRO	Kronos Worldwide Inc
KSA	Lehman Abs Corporation
KSK	Lehman Abs Corporation
KSM	Scudder Strategic Municiple Income Trust
KSP	K-sea Transportation Partners Lp
KSS	Kohl's Corporation
KST	Scudder Strategic Income Trust
KSU	Kansas City Southern
KSU.P	KAAS CITY SOUTHERN PFD
KTC	Korea Telecom Corporation
KTF	Scudder Municiple Income Trust
KTH	Lehman Abs Corporation
KTN	Lehman Abs Corporation
KTP	Lehman Abs Corporation
KTV	Lehman Abs Corporation
KTX	Lehman Abs Corporation
KUB	Kubota Corporation
KV.A	K-v Pharmaceutical Company
KV.B	K-v Pharmaceutical Company
KVF	Lehman Abs Corporation
KVJ	Lehman Abs Corporation
KVM	Lehman Abs Corporation
KVN	Lehman Abs Corporation
KVR	Lehman Abs Corporation
KVT	Lehman Abs Corporation
KVU	Lehman Abs Corporation
KVW	Lehman Abs Corporation
KWK	Quicksilver Resources Inc.
KWR	Quaker Chemical Corporation
KYE	Kayne Anderson Energy Total Return Fund, Inc.
KYN	Kayne Anderson Mlp Investment Company
KYO	Kyocera Corporation
L	Liberty Media Corporation
LAB	Labranche & Co., Inc.
LAD	Lithia Motors, Inc.
LAZ	Lazard Ltd.
LBF	Scudder Global High Income Fund, Inc.
LBY	Libbey, Inc.
LCC	Us Airways Group, Inc. New
LCM	Advent/Claymore Enhanced Growth & Income Fund
LDF	Latin American Discovery Fund, Inc. (the)
LDK	LDK SOLAR CO. LTD
LDL	Lydall, Inc.
LDR	Landauer, Inc.
LEA	Lear Corporation
LEE	Lee Enterprises, Incorporated
LEG	Leggett & Platt, Incorporated
LEN	Lennar Corporation
LEN.B	Lennar Corp
LEO	Dreyfus Strategic Municipals Inc.
LF	Leapfrog Enterprises Inc
LFC	China Life Insurance Company
LFL	Lan Chile S.a.
LFT	LONGTOP FINANCIAL TECHNOLOGIES
LG	Laclede Group, Inc.
LGF	Lions Gate Entertainment Corporation
LGI	Lazard Global Total Return And Income Fund
LH	Laboratory Corporation Of America Holdings
LHO	Lasalle Hotel Properties
LHO-B	Lasalle Hotel Pptys
LHO-D	Lasalle Hotel Pptys
LHO-E	Lasalle Hotel Pptys
LHO-G	Lasalle Hotel Pptys
LII	Lennox International, Inc.
LIZ	Liz Claiborne, Inc.
LL	LUMBER LIQUIDATORS INC
LLL	L-3 Communications Holdings, Inc.
LLY	Eli Lilly and Company
LM	Legg Mason, Inc.
LMC	LUDIN MINING CORP
LMI	LEGG MASON CORP UNIT
LMT	Lockheed Martin Corporation
LNC	Lincoln Natl Corp Ind
LNC-F	Lincoln Natl Cap Vi
LNC-G	Lincoln Natl Corp Ind
LNN	Lindsay Corporation
LNT	Alliant Energy Corporation
LNY	Landry's Restaurants, Inc.
LO	LORILLARD INC
LOR	Lazard World Dividend & Income Fund, Inc.
LOW	Lowe's Companies, Inc.
LPL	Lg.philips
LPS	LENDER PROCESSING SERVICES INC
LPX	Louisiana-pacific Corporation
LRN	K12 INC
LRT	Ll&e Royalty Trust
LRY	Liberty Property Trust
LSE	Caplease Funding Inc
LSE-A	Caplease Funding Inc
LSI	Lsi Logic Corporation
LTC	Ltc Properties, Inc.
LTC-E	Ltc Pptys Inc
LTC-F	Ltc Pptys Inc
LTD	Limited Brands, Inc.
LTM	Life Time Fitness
LUB	Luby's, Inc.
LUK	Leucadia National Corporation
LUV	Southwest Airlines Company
LUX	Luxottica Group, S.p.a.
LVB	Steinway Musical Instruments, Inc.
LVS	Las Vegas Sands Corp.
LXK	Lexmark International, Inc.
LXP	Lexington Realty Trust
LXP-B	Lexington Realty Trust
LXP-C	Lexington Realty Trust
LXP-D	Lexington Rlty Tr
LXU	LSB INDUSTRIES INC
LYG	Lloyds Tsb Group Plc
LYV	CCE Spinco Inc.
LZ	Lubrizol Corporation (the)
LZB	La-z-boy Incorporated
M	MACY'S  INC
MA	Mastercard Incorporated
MAA	Mid-america Apartment Communities, Inc.
MAA-H	Mid-amer Apt Cmntys Inc
MAC	Macerich Company (the)
MAD	Madeco Sa
MAF	Municipal Advantage Fund, Inc.
MAG	Magnetek, Inc.
MAN	Manpower Inc
MAR	Marriot International
MAS	Masco Corporation
MAT	Mattel, Inc.
MAV	Pioneer Municipal High Income Advantage Trust
MAY	MAY DEPT STORES CO
MBI	Mbia, Inc.
MBT	Mobile Telesystems
MCA	Blackrock MuniYield California Insured Fund Inc.
MCD	Mcdonald's Corporation
MCI	Massmutual Corporate Investors
MCK	Mckesson Corporation
MCN	Madison/claymore Covered Call Fund
MCO	Moody's Corporation
MCR	Mfs Charter Income Trust
MCS	Marcus Corporation (the)
MCY	Mercury General Corporation
MD	MEDNAX INC
MDC	M.d.c. Holdings, Inc.
MDP	Meredith Corporation
MDR	Mcdermott International, Inc.
MDS	Midas, Inc.
MDT	Medtronic, Inc.
MDU	Mdu Res Group Inc
MDZ	Mds, Inc.
ME	Mariner Energy, Inc.
MED	Medifast Inc
MEE	Massey Energy Company
MEG	Media General, Inc.
MEI	METHODE ELECTRONICS INC
MEN	Blackrock MuniEnhanced Fund Inc.
MER	Merrill Lynch & Co., Inc.
MER-D	Merrill Lynch Pfd Cap Tr Iii
MER-E	Merrill Lynch Pfd Cap Tr Iv
MER-F	Merrill Lynch Pfd Cap Tr V
MER-G	Merrill Lynch & Co Inc
MER-H	Merrill Lynch & Co Inc
MER-I	Merrill Lynch & Co Inc
MER-J	Merrill Lynch & Co Inc
MER-K	Merrill Lynch Cap Tr I
MER-L	MERRILL LYNCH & CO. I    NC. DEP
MER-M	MERRILL LYNCH CAPITAL TRUST II
MER-N	MERRILL LYNCH DEP SH
MER-O	MERRILL LYNCH DEP SH
MER-P	MERRILL LYNCH CAPITAL TRUST II
MER-Q	MERRILL  LYNCH AND CO INC
MET	Metlife, Inc.
MET-A	Metlife Inc
MET-B	Metlife Inc
MEU	Metlife, Inc.
MF	MF Global Ltd
MFA	America First Mortgage Investments Inc.
MFA-A	America First Mortgage Investments Inc.
MFB	Maidenform Brands, Inc.
MFC	Manulife Financial Corp
MFD	Macquarie/first Trust Global
MFE	Networks Associates, Inc.
MFG	Mizuho Financial Group, Inc.
MFL	Blackrock MuniHoldings Florida Insured Fund Inc.
MFM	Mfs Municipal Income Trust
MFT	Blackrock MuniYield Florida Insured Fund
MFV	Mfs Special Value Trust
MFW	M&f Worldwide Corporation
MGA	Magna International, Inc.
MGB	Morgan Stanley Global Opportunity Bond Fund, Inc.
MGF	Mfs Government Markets Income Trust
MGG	Magellan Midstream Partners L.p.
MGI	Moneygram International, Inc.
MGM	Mgm Mirage
MGS	Metrogas, S.a.
MGU	Macquarie Global Infrastructure Total Return Fund Inc.
MHD	Blackrock MuniHoldings Fund Inc.
MHF	Western Asset Municipal High Income Fund, Inc.
MHI	Pioneer Municipal High Income Trust
MHK	Mohawk Industries, Inc.
MHN	Blackrock MuniHoldings New York Insured Fund Inc.
MHO	M/i Homes, Inc.
MHO-A	M/I HOMES DEPOSITORY
MHP	Mcgraw-hill Companies, Inc. (the)
MHS	Medcohealth Solutions Inc
MHY	Western Asset Managed High Income Fund, Inc.
MI	Marshall & Ilsley Corporation
MIC	Macquarie Infrastructure Company Trust
MIG	Meadowbrook Insurance Group, Inc.
MIL	Millipore Corporation
MIM	Mi Developments Inc
MIN	Mfs Intermediate Income Trust
MIR	Mirant Corp
MIR.A	MIRANT CO A WT WI
MIR.B	MIRANT B WT WI
MIY	Blackrock MuniYield Michigan Insured Fund Inc.
MJF	Msdw Structured Asset Corporation
MJH	Ms Structured Asset Corp Saturns Ge Cap Corp Series 2002-14
MJI	Blackrock MuniYield New Jersey Insured Fund Inc.
MJT	Ms Dw Structured Asset Corp Saturns
MJV	Ms Structured Asset Corp Saturns Ge Cap Corp Series 2002-14
MJY	Mdsw Structured Asset Corporation
MKC	Mccormick & Company, Incorporated
MKC.V	Mccormick & Co Inc
MKL	Markel Corporation
MKS	Ms Structured Asset Corp Saturns Ge Cap Corp Series 2002-14
MKV	Markel Corporation
MLG	Metlife, Inc.
MLI	Mueller Industries, Inc.
MLM	Martin Marietta Materials, Inc.
MLP	MAUI LAND & PINE
MLR	Miller Industries, Inc.
MMC	Marsh & Mclennan Companies, Inc.
MMM	3M Company
MMP	Magellan Midstream Partners L.p.
MMR	Mcmoran Exploration Company
MMR-M	MCMORAN EXPLORATION CO
MMS	Maximus, Inc.
MMT	Mfs Multimarket Income Trust
MMU	Western Asset Managed Municipals Fund, Inc.
MNC	Monaco Coach Corporation
MNE	Blackrock Muni New York Intermediate Duration Fund Inc
MNI	Mcclatchy Company (the)
MNP	Western Asset Municipal Partners Fund, Inc.
MNT	Mentor Corporation
MO	Altria Group
MOD	Modine Manufacturing Company
MOG.A	Moog Inc
MOG.B	Moog Inc
MOH	Molina Healthcare Inc
MON	Monsanto Company
MOS	Mosaic Company (the)
MOT	Motorola, Inc.
MOV	Movado Group Inc.
MP-D	Mississippi Power Co
MPA	Blackrock MuniYield Pennsylvania Insured Fund
MPG	Maguire Properties Inc
MPG-A	Maguire Pptys Inc
MPJ	Mississippi Power Company
MPR	Met-pro Corporation
MPS	Modis Professional Services, Inc.
MPV	Massmutual Participation Investors
MPW	Medical Properties Trust, Inc.
MPX	Marine Products Corporation
MQT	Blackrock MuniYield Quality Fund II Inc.
MQY	Blackrock MuniYield Quality Fund Inc.
MR	Mindray Medical International
MRF	American Income Fund Inc.
MRH	Montpelier Re Holdings Ltd
MRK	Merck & Company, Inc.
MRO	Marathon Oil Corporation
MRT	Morton's Restaurant Group, Inc.
MRX	Medicis Pharmaceutical Corporation
MS	Morgan Stanley
MS-A	Morgan Stanley
MSA	Mine Safety Appliances Company
MSB	Mesabi Trust
MSC	Material Sciences Corporation
MSD	Morgan Stanley Emerging Markets Debt Fund, Inc.
MSF	Morgan Stanley Emerging Markets Fund, Inc.
MSJ	Morgan Stanley Cap Trust Vi
MSK	Grupo Industrial Maseca, S.A. de C.V.
MSM	Msc Industrial Direct Company, Inc.
MSO	Martha Stewart Living Omnimedia, Inc.
MSP	Madison Strategic Sector Premium Fund
MSY	Morgan Stanley High Yield Fund, Inc.
MSZ	Morgan Stanley Capital Trust Vii
MT	Arcelor Mittal
MTA	Matav
MTB	M&t Bank Corporation
MTB-A	M& T CAPITAL TRUST IV
MTD	Mettler-toledo International, Inc.
MTE	Mahanagar Telephone Nigam Ltd
MTG	Mgic Investment Corporation
MTH	Meritage Corporation
MTL	Mechel Steel Group Oao
MTN	Vail Resorts, Inc.
MTP	MLP & STRATEGIC EQTY FU    ND IN
MTR	Mesa Royalty Trust
MTS	Montgomery Street Income Securities, Inc.
MTU	Mitsubishi Ufj Financial Group Inc
MTW	Manitowoc Company, Inc.
MTX	Minerals Technologies Inc.
MTZ	Mastec, Inc.
MU	Micron Technology, Inc.
MUA	Blackrock MuniAssets Fund Inc.
MUC	Blackrock MuniHoldings California Insured Fund  Inc.
MUE	Blackrock MuniHoldings Insured Fund II Inc.
MUH	Blackrock MuniHoldings Fund II Inc.
MUI	Blackrock Muni Intermediate Duration Fund Inc
MUJ	Blackrock MuniHoldings New Jersey Insured Fund Inc.
MUR	Murphy Oil Corporation
MUS	Blackrock MuniHoldings Insured Fund Inc.
MV	METAVANTE TECHNOLOGIES INC
MVC	Mvc Capital
MVL	Marvel Enterprises, Inc.
MVO	Mv Oil Trust
MVT	Blackrock MuniVest Fund II Inc.
MW	Men's Wearhouse, Inc. (the)
MWA	Mueller Water Products
MWA.B	Mueller Wtr Prods Inc
MWE	MARKWEST ENERGY PTNR
MWG	Morgan Stanley Cap Tr Iv
MWO	Morgan Stanley Cap Tr V
MWR	Morgan Stanley Cap Tr Iii
MWV	Meadwestvaco Corporation
MWW	MOTER WORLDWIDE
MWY	Midway Games Inc.
MXB	MSCI INC
MXE	Mexico Equity And Income Fund, Inc. (the)
MXE.P	MEXICO EQTY AND INCOME FUND IN
MXF	Mexico Fund, Inc. (the)
MXT	Metris Companies Inc.
MYC	Blackrock MuniYield California Fund Inc.
MYD	Blackrock MuniYield Fund Inc.
MYE	Myers Industries, Inc.
MYF	Blackrock MuniYield Florida Fund
MYI	Blackrock MuniYield Insured Fund Inc.
MYJ	Blackrock MuniYield New Jersey Fund Inc.
MYL	Mylan Laboratories, Inc.
MYL-A	MYLAN INC MANDATORY CV PFD
MYM	Blackrock MuniYield Michigan Insured Fund II Inc.
MYN	Blackrock MuniYield New York Insured Fund Inc.
MZF	Mbia Capital/claymore Total Return Fund Inc
N	Inco Ltd.
NAC	Nuveen California Dividend Advantage Municipal Fund
NAD	Nuveen Dividend Advantage Municipal Fund
NAI	Nicholas-applegate International
NAL	Newalliance Bancshares, Inc.
NAN	Nuveen New York Dividend Advantage Municipal Fund
NAT	Nordic American Tanker Shipping
NAV	Navistar International Corporation
NAV-D	NAVISTAR INTL CORP HLDG
NAZ	Nuveen Arizona Premium Income Municipal Fund, Inc.
NBG	Natl Bk Greece Ads
NBG-A	NATIONAL BANK OF GREECE SA
NBL	Noble Energy Inc.
NBR	Nabors Industries, Inc.
NC	Nacco Industries, Inc.
NCA	Nuveen California Municipal Value Fund, Inc.
NCC	National City Corporation
NCC-A	National City Cap Tr Ii
NCC-B	NATIONAL CITY CAPITAL TRUST II
NCC-C	NATIONAL CITY CAPITAL TRUST IV
NCC-F	NATIONAL CITY CORPORATION SER
NCI	Navigant Consulting, Inc.
NCL	Nuveen Insured California Premium Income Municipal Fund Ii, In
NCO	Nuveen California Municipal Market Opportunity Fund, Inc.
NCP	Nuveen California Performance Plus Municipal Fund, Inc.
NCR	Ncr Corporation
NCS	Nci Building Systems, Inc.
NCT	Newcastle Investment Corporation
NCT-B	Newcastle Invt Corp
NCT-C	Newcastle Invt Corp
NCT-D	NEWCASTLE INVESTMENT CORP.
NCV	Nicholas-applegate Convertible & Income Fund
NCX	Nova Chemicals Corporation
NCZ	Nicholas-applegate Convertible & Income Fund Ii
NDN	99 Cents Only Stores
NE	Noble Corporation
NED	NOAH EDUCATION HOLDINGS LTD
NEM	Newmont Mining Corporation (holding Company)
NEU	Newmarket Corporation
NFG	National Fuel Gas Company
NFJ	Nfj Dividend, Interest & Premium Strategy Fund
NFL	Nuveen Insured Florida Premium Income Municipal Fund
NFP	National Financial Partners Corporation
NFS	Nationwide Financial Services, Inc.
NFX	Newfield Exploration Company
NGG	National Grid Transco, Plc
NGS	NATURAL GAS SVCS GRP
NGT	Eastern American Natural Gas Trust
NGZ	NICHOLAS APPLEGATE GLB EQTY &
NHI	National Health Investors, Inc.
NHP	Nationwide Health Properties, Inc.
NHP-B	Nationwide Health Pptys Inc
NHS	NEUBERGER BERMAN HIGH YIELD ST
NI	Northern Indiana Public Service Company
NIE	Nicholas-applegate Equity & Convertible Income Fund
NIF	Nuveen Premier Insured Municipal Income Fund, Inc.
NIM	Nuveen Select Maturities Municipal Fund
NIO	Nuveen Insured Municipal Opportunity Fund, Inc.
NJ	Nidec Corporation (nihon Densan Kabushiki Kaisha)
NJR	Newjersey Resources Corporation
NKE	Nike, Inc.
NL	Nl Industries, Inc.
NLC	Nalco Holding Company
NLS	Nautilus Group, Inc. (the)
NLY	Annaly Capital Management Inc
NLY-A	Annaly Capital Management Inc
NM	NAVIOS MARITIME HOLDINGS INC
NMA	Nuveen Municipal Advantage Fund, Inc.
NMD	NUVEEN MUNICIPAL HIGH INCOME O
NMI	Nuveen Municipal Income Fund, Inc.
NMK-B	Niagara Mohawk Pwr Corp
NMK-C	Niagara Mohawk Pwr Corp
NMM	NAVIOS MARITIME PARTNERS L.P.
NMO	Nuveen Municipal Market Opportunity Fund, Inc.
NMP	Nuveen Michigan Premium Income Municipal Fund, Inc.
NMR	Nomura Holdings Inc Adr
NMT	Nuveen Massachusetts Premium Income Municipal Fund
NMY	Nuveen Maryland Premium Income Municipal Fund
NNA	NAVIOS MARITIME ACQUISITION CO
NNA.U	NAVIOS MARITIME ACQUISITION CO
NNA.W	NAVIOS MARITIME ACQUISITION CO
NNC	Nuveen North Carolina Premium Income Municipal Fund
NNF	Nuveen Insured New York Premium Income Municipal Fund, Inc.
NNI	Nelnet, Inc.
NNJ	Nuveen New Jersey Premium Income Municipal Fund, Inc.
NNN	Commercial Net Lease Realty, Inc.
NNN-C	National Retail Properties I
NNP	Nuveen New York Performance Plus Municipal Fund, Inc.
NNY	Nuveen New York Municipal Value Fund, Inc.
NOA	North American Energy Partners, Inc.
NOC	Northrop Grumman Corporation
NOK	Nokia Corporation
NOV	National-oilwell, Inc.
NP	Neenah Paper, Inc.
NPC	Nuveen Insured California Premium Income Fund, Inc.
NPD	China Nepstar Chain Drugstore Ltd
NPF	Nuveen Premier Municipal Income Fund, Inc.
NPI	Nuveen Premium Income Municipal Fund, Inc.
NPK	National Presto Industries, Inc.
NPM	Nuveen Premium Income Municipal Fund Ii, Inc.
NPO	Enpro Industries
NPP	Nuveen Performance Plus Municipal Fund, Inc.
NPT	Nuveen Premium Income Municipal Fund Iv, Inc.
NPV	Nuveen Virginia Premium Income Municipal Fund
NPX	Nuveen Insured Premium Income Municipal Fund Ii
NPY	Nuveen Pennsylvania Premium Income Municipal Fund Ii
NQC	Nuveen California Investment Quality Municipal Fund, Inc.
NQF	Nuveen Florida Investment Quality Municipal Fund
NQI	Nuveen Insured Quality Municipal Fund, Inc.
NQJ	Nuveen New Jersey Investment Quality Municipal Fund, Inc.
NQM	Nuveen Investment Quality Municipal Fund, Inc.
NQN	Nuveen New York Investment Quality Municipal Fund, Inc.
NQP	Nuveen Pennsylvania Investment Quality Municipal Fund, Inc.
NQS	Nuveen Select Quality Municipal Fund, Inc.
NQU	Nuveen Quality Income Municipal Fund, Inc.
NR	Newpark Resources, Inc.
NRC	National Rural Utilities Cooperative Finance Corp
NRF	Northstar Realty Finance Corp.
NRF-A	Northstar Rlty Fin Corp
NRF-B	Northstar Rlty Fin Corp
NRG	Nrg Energy, Inc.
NRG-A	Nrg Energy Inc
NRN	National Rural Utilities Cooperative Finance Corp
NRP	Natural Resource Partners Lp
NRT	North European Oil Royality Trust
NRU	National Rural Utilities Cooperative Finance Corp
NS	NUSTAR ENERGY L P
NSC	Norfolk Souther Corporation
NSH	Nashua Corporation
NSL	Nuveen Senior Income Fund
NSM	National Semiconductor Corporation
NSR	Neustar, Inc.
NST	Nstar
NT	Nortel Networks Corporation
NTC	Nuveen Connecticut Premium Income Municipal Fund
NTE	Nam Tai Electronics, Inc.
NTG	Natco Group Inc.
NTL	Nortel Inversora Sa, Adr
NTT	Nippon Telegraph And Telephone Corporation
NTX	Nuveen Texas Quality Income Municipal Fund
NTY	Nbty, Inc.
NTZ	Natuzzi, S.p.a.
NU	Northeast Utilities
NUC	Nuveen California Quality Income Municipal Fund, Inc.
NUE	Nucor Corporation
NUF	Nuveen Florida Quality Income Municipal Fund, Inc.
NUM	Nuveen Michigan Quality Income Municipal Fund, Inc.
NUN	Nuveen New York Quality Income Municipal Fund, Inc.
NUO	Nuveen Ohio Quality Income Municipal Fund, Inc.
NUS	Nu Skin Enterprises, Inc.
NUV	Nuveen Municipal Value Fund, Inc.
NVC	Nuveen California Select Quality Municipal Fund, Inc.
NVE	NV ENERGY INC
NVN	Nuveen New York Select Quality Municipal Fund, Inc.
NVO	Novo Nordisk A/s
NVR	N V R L P
NVS	Novartis Ag
NW-C	National Westminster Bk Plc
NWE	NORTHWESTERN CORPORATION
NWK	Network Equipment Technologies, Inc.
NWL	Newell Rubbermaid Inc.
NWN	Northwest Natural Gas Company
NWS	News Corporation (the)
NWS.A	News Corporation (the)
NWY	New York & Company, Inc.
NX	Quanex Corporation
NXC	Nuveen Insured California Select Tax-free Income Portfolio
NXN	Nuveen Insured New York Select Tax-free Income Portfolio
NXP	Nuveen Select Tax Free Income Portfolio
NXQ	Nuveen Select Tax Free Income Portfolio Ii
NXR	Nuveen Select Tax Free Income Portfolio Iii
NXY	Nexen, Inc.
NXY-B	Nexen Inc
NYB	New York Community Bancorp, Inc.
NYB-U	New York Cmnty Cap Tr V
NYM	Nymagic, Inc.
NYT	New York Times Company (the)
NYX	Nyse Group, Inc.
NZT	Telecom Corporation
O	Realty Income Corporation
O-D	Realty Income Corp
O-E	Ope
OB	Onebeacon Insurance Group, Ltd.
OC	Owens Corning Inc
OC.B	OWE CORNING [B STOCK]
OCN	Ocwen Financial Corporation
OCR	Omnicare, Inc.
OCR-A	Omnicare Cap Tr I
OCR-B	Omnicare Cap Tr Ii
ODC	Oil-dri Corporation Of America
ODP	Office Depot, Inc.
OEH	Orient-express Hotels, Ltd.
OFC	Corporate Office Properties Trust
OFC-G	Corporate Office Properties Trust
OFC-H	Corporate Office Properties Trust
OFC-J	Corporate Office Properties Trust
OFG	Oriental Financial Group, Inc.
OFG-A	Oriental Finl Group Inc
OFG-B	Oriental Finl Group Inc
OGE	Oge Energy Corporation
OHI	Omega Healthcare Investors, Inc.
OHI-D	Omega Healthcare Invs Inc
OI	Owens-illinois, Inc.
OIA	Ms Municipal Income Opportunities Trust
OIB	Ms Municipal Income Opportunities Trust Ii
OIC	Ms Municipal Income Opportunities Trust Iii
OII	Oceaneering International, Inc.
OIS	Oil States International, Inc.
OKE	Oneok, Inc.
OKS	Northern Border Partners, L.p.
OLA	Old Mutual/claymore Long-short Fund
OLN	Olin Corporation
OLP	One Liberty Properties, Inc.
OMC	Omnicom Group Inc.
OME	Omega Protein Corporation
OMG	Om Group, Inc.
OMI	Owens & Minor, Inc.
OMN	Omnova Solutions Inc.
OMX	Boise Cascade Corporation
ONB	Old National Bancorp Capital Trust I
ONB-B	Onb Cap Tr Ii
ONE-W	Bank One Corporation
OPY	Oppenheimer Holdings, Inc.
ORA	Ormat Technologies, Inc.
ORB	Orbital Sciences Corporation
ORH	Odyssey Re Holdings Corporation
ORH-A	Odyssey Re Hldgs Corp
ORH-B	Odyssey Re Hldgs Corp
ORI	Old Republic International Corporation
OSG	Overseas Shipholding Group, Inc.
OSK	Oshkosh Truck Corporation
OSM	Slm Corporation
OSP	OSG AMERICA LP
OTE	Hellenic Telecommunication Organization, S.a.
OWW	ORBITZ WORLDWIDE INC
OXM	Oxford Industries, Inc.
OXY	Occidental Petroleum Corporation
OZM	OCH ZIFF CAPITAL MANAGEMENT GR
PAA	Plains All American Pipeline, L.p.
PAC	Grupo Aeroportuario Del Pacifico, S.a. De C.v.
PAG	PENSKE AUTOMOTIVE GROUP INC.
PAI	Pacific American Income, Inc.
PAR	3PAR INC
PAS	Whitman Corporation
PAY	Veriphone Holdings, Inc.
PBG	Pepsi Bottling Group, Inc. (the)
PBH	Prestige Brand Holdings, Inc.
PBI	Pitney Bowes Inc
PBR	Petroleo Brasileiro S.a.- Petrobras
PBR.A	Petroleo Brasileir
PBT	Permian Basin Royalty Trust
PBY	Pep Boys-manny, Moe & Jack (the)
PC	PANASONIC CORPORATION
PCF	Putnam High Income Bond Fund
PCG	Pacific Gas & Electric Co.
PCH	Potlatch Corporation
PCK	Pimco California Municipal Income Fund Ii
PCL	Plum Creek Timber Company, Inc.
PCM	Pimco Commercial Mortgage Securities Trust, Inc.
PCN	Pimco Corporate Income Fund
PCP	Precision Castparts Corporation
PCQ	Pimco California Municipal Income Fund
PCR	Perini Corporation
PCS	Sprint Pcs Group
PCU	Southern Peru Copper Corporation
PCX	PATRIOT COAL CORPORATION
PCZ	Petro-canada
PDA	Perdigao S.a.
PDE	Pride International, Inc.
PDS	Precision Drilling Corporation
PDT	John Hancock Patriot Premium Dividend Fund Ii
PDX	Pediatrix Medical Group, Inc.
PE-B	Peco Energy Co
PE-C	Peco Energy Co
PE-D	Peco Energy Co
PEC	Pike Electric Corp.
PEG	Public Service Enterprise Group Incorporated
PEG-A	Public Svc Elec & Gas Co
PEG-C	Public Svc Elec & Gas Co
PEG-D	Public Svc Elec & Gas Co
PEG-E	Public Svc Elec & Gas Co
PEI	Pennsylvania Real Estate Investment Trust
PEO	Petroleum Resources Corporation
PEP	Pepsico, Inc.
PER	Perot Systems Corporation
PFD	Flaherty & Crumrine Preferred Income Fund Incorporated
PFE	Pfizer, Inc.
PFG	Principal Financial Group Inc
PFG-B	Principal Financial Group In
PFH	Cabco Tr Jcp 7.625
PFK	Prudential Financial Inflation-linked Retail Medium
PFL	Pimco Floating Rate Income Fund
PFN	Pimco Floating Rate Strategy Fund
PFO	Flaherty & Crumrine Preferred Income Opportunity Fund Inc
PFS	Provident Financial Services
PFX	Phoenix Companies, Inc.
PG	Procter & Gamble Company (the)
PGE-B	Prime Group Realty Trust
PGH	Pengrowth Energy Trust
PGI	Ptek Holdings, Inc.
PGN	Progress Energy Inc
PGP	Pimco Global Stocksplus & Income Fund
PGR	Progressive Corporation (the)
PH	Parker-hannifin Corporation
PHA	Pulte Homes, Inc.
PHD	Pioneer Floating Rate Trust
PHG	Koninklijke Philips Electronics, N.v.
PHH	Phh Corp
PHI	Philippine Long Distance Telephone Company
PHK	Pimco High Income Fund
PHM	Pulte Homes, Inc.
PHR	PRUDENTIAL FINANCIAL INC 9.0%
PHT	Pioneer High Income Trust
PHX	PANHANDLE OIL & GAS
PIA	Ms Municipal Premium Income Trust
PIF	Insured Municipal Income Fund, Inc.
PII	Polaris Industries Inc.
PIJ	Merrill Lynch Depositor, Inc.
PIM	Putnam Master Intermediate Income Trust
PIR	Pier 1 Imports, Inc.
PIS	Merrill Lynch Depositor, Inc.
PIY	Merrill Lynch Depositor, Inc.
PJA	Preferred Plus Trust Ser Qws 2 Tr Ctf
PJC	Piper Jaffray Companies
PJE	Merrill Lynch Preferredplus Tr
PJI	Pplus Trust
PJJ	Merrill Lynch Depositor Inc Preferred Plus Trust Elp-1
PJL	Preferredplus Tr
PJR	Merrill Lynch Depositor, Inc.
PJS	Preferredplus Trust
PJT	Preferred Plus Trust Gec-1 6.05
PJZ	Pplus Trust
PKD	Parker Drilling Company
PKE	Park Electrochemical Corporation
PKG	Packaging Corporation Of America
PKH	Merrill Lynch Depositor Inc Preferred Plus Trust Ser Qws-1 7.7
PKI	Perkinelmer, Inc.
PKJ	Merrill Lynch Depositor, Inc.
PKK	Merrill Lynch Depositor, Inc.
PKM	Merrill Lynch Depositor, Inc.
PKO	Preferred Plus Tr
PKX	Pohang Iron & Steel Co., Ltd.
PKY	Parkway Properties, Inc.
PKY-D	Parkway Pptys Inc
PL	Protective Life Corporation
PL-A	Plc Cap Tr Iv
PL-B	Plc Cap Tr V
PL-D	Protective Life Corp
PL-S	Plc Capital Trust Iii
PLA	Playboy Enterprises, Inc.
PLA.A	Playboy Enterprises, Inc.
PLD	Prologis
PLD-F	Prologis
PLD-G	Prologis
PLL	Pall Corporation
PLS	Ppl Energy Supply Llc
PLT	Plantronics, Inc.
PLV	PPL CAPITAL FDG INC
PM	PHILIP MORRIS INTERNATIONAL IN
PMB.P	BB&T Corporation
PMC	PHARMERICA CORPORATION
PMF	Pimco Municipal Income Fund
PMI	Pmi Group, Inc. (the)
PML	Pimco Municipal Income Fund Ii
PMM	Putnam Managed Municipal Income Trust
PMO	Putnam Municipal Opportunities Trust
PMX	Pimco Municipal Income Fund Iii
PNC	Pnc Bank Corp.
PNC-C	Pnc Finl Svcs Group Inc
PNC-L	PNC FINL PR L
PNF	Pimco New York Municipal Income Fund
PNH	PNC CAPITAL TRUST E
PNI	Pimco New York Municipal Income Fund Ii
PNK	Pinnacle Entertainment, Inc.
PNM	Pnm Resources, Inc. (holding Co.)
PNR	Pentair, Inc.
PNU	Pnc Bank Corp.
PNW	Pinnacle West Capital Corporation
PNX	Phoenix Companies, Inc. (the)
PNY	Piedmont Natural Gas Company, Inc.
POH	Public Service Company Of Oklahoma
POL	Polyone Corporation
POM	Potomac Electric Power Company
POR	Portland General Electric Co
POT	Potash Corporation Of Saskatchewan Inc.
PPD	Pre-paid Legal Services, Inc.
PPG	Ppg Industries, Inc.
PPL	Ppl Corporation
PPL-A	Ppl Elec Utils Corp
PPL-B	Ppl Elec Utils Corp
PPM	Investment Grade Municipal Income Fund, Inc.
PPO	POLYPORE INTERNATIONAL INC.
PPR	Ing Prime Rate Trust
PPS	Post Properties, Inc.
PPS-A	Post Pptys Inc
PPS-B	Post Pptys Inc
PPT	Putnam Premier Income Trust
PQ	Petroquest Energy Inc
PRA	Pro-assurance Corporation
PRD	Primus Guaranty, Ltd.
PRE	Partnerre Ltd.
PRE-C	Partnerre Ltd
PRE-D	Partnerre Ltd
PRM	Primedia, Inc.
PRO	PROS HOLDINGS INC
PRS	Primus Guaranty, Ltd.
PRU	Prudential Financial Inc
PRX	Pharmaceutical Resources, Inc.
PSA	Public Storage, Inc.
PSA-A	Public Storage Inc
PSA-B	Public Storage Inc
PSA-C	Public Storage Inc
PSA-D	Public Storage Inc
PSA-E	Public Storage Inc
PSA-F	Public Storage Inc
PSA-G	Public Storage Inc
PSA-H	Public Storage Inc
PSA-I	Public Storage Inc
PSA-K	Public Storage Inc
PSA-L	Public Storage Inc
PSA-M	Public Storage Inc
PSA-N	PUBLIC STORAGE7% SERIES N
PSA-V	Public Storage Inc
PSA-W	Public Storage Inc
PSA-X	Public Storage Inc
PSA-Z	Public Storage Inc
PSA.A	Public Storage Inc
PSB	PS BUSINESS PARKS
PSB-H	PS BUS PKS DEP PFD H
PSB-I	PS BUS PKS DEP SHS
PSB-K	PS BUS PARK K
PSB-L	PS BUSINESS PKS 7.60
PSB-M	PS BUSINESS PFD M
PSB-O	PS BUSINESS PKS
PSB-P	PS BUSINESS PARKS I
PSD	Puget Sound Energy
PSE	PIONEER SOUTHWEST ENERGY PARTN
PSO	Pearson, Plc
PSS	Collective Brands Inc.
PSW	Blackrock Preferred and Corporate Income Strategies Fund Inc
PSY	Blackrock Preferred Income Strategies Fund Inc
PT	Portugal Telecom Sgps, S.a .
PTC	Par Technology Corporation
PTI	Patni Computer Systems
PTP	Platinum Underwriters Holdings Ltd
PTP-A	Platinum Underwriter Hldgs L
PTR	Petrochina Company
PTV	Pactiv Corporation
PTY	Pimco Corporate Opportunity Fund
PUK	Prudential Public Company
PUK-A	Prudential Plc
PUK.P	Prudential Public Company PR
PVA	Penn Virginia Corporation
PVD	Administradora de Fondos de Pensiones-Provida S.A.
PVG	Penn Virginia Gp Holdings, L.p.
PVH	Phillips-van Heusen Corporation
PVR	Penn Virginia Resource Partners Lp
PVX	Provident Energy Trust
PWE	Penn West Energy Trust
PWR	Quanta Services, Inc.
PX	Praxair, Inc.
PXD	Pioneer Natural Resources Company
PXP	Plains Exploration & Production Company
PYA	Pplus Trust
PYB	Pplus Trust
PYC	Pplus Trust
PYE	Pplus Trust
PYG	Pplus Trust
PYI	Pplus Trust
PYJ	Pplus Trust
PYK	Pplus Trust
PYL	Pplus Trust
PYN	Pimco New York Municipal Income Fund Iii
PYO	Pplus Trust
PYS	Pplus Trust
PYT	Pplus Trust
PYV	Pplus Trust
PYY	Merrill Lynch Depositor, Inc.
PZB	Merrill Lynch Depositor, Inc.
PZC	Pimco California Municipal Income Fund Iii
PZE	Petrobras Energia Participaciones Sa
PZN	PZENA INV MGMT CL A
Q	Qwest Communications International Inc.
QI	Qimonda Ag
QTM	Quantum Corporation
QXM	QIAO XING MOBILE COM
R	Ryder System, Inc.
RAD	Rite Aid Corporation
RAH	Ralcorp Holdings, Inc.
RAI	Reynolds American Inc
RAS	Rait Financial Trust
RAS-A	Rait Financial Trust
RAS-B	Rait Financial Trust
RAS-C	RAIT FINANCIAL TRUST
RAX	RACKSPACE HOSTING INC
RBA	Ritchie Bros. Auctioneers Incorporated
RBC	Regal-beloit Corporation
RBN	Robbins & Myers, Inc.
RBS	THE ROYAL BANK OF SCOTLAND GRO
RBS-F	Royal Bk Scotland Group Plc
RBS-H	Royal Bk Scotland Group Plc
RBS-L	Royal Bk Scotland Group Plc
RBS-M	Royal Bk Scotland Group Plc
RBS-N	Royal Bk Scotland Group Plc
RBS-P	Royal Bk Scotland Group Plc
RBS-Q	Royal Bk Scotland Group Plc
RBS-R	Royal Bk Scotland Group Plc
RBS-S	THE ROYAL BANK OF SCOTLAND GRO
RBS-T	THR ROYAL BANK OF SCOTLAND GRO
RBV	CBS Corporation
RC	Grupo Radio Centro, S.a. De C.v.
RCC	Small Cap Premium
RCI	Renal Care Group, Inc.
RCL	Royal Caribbean Cruises Ltd.
RCS	Rcm Strategic Global Government Fund, Inc.
RDC	Rowan Companies, Inc.
RDK	Ruddick Corporation
RDN	Radian Group Inc.
RDS.A	Royal Dutch Shell
RDS.B	Royal Dutch Shell Plc
RDY	Dr. Reddy's Laboratories Ltd
RE	Everest Re Group, Ltd.
RE-B	Everest Re Cap Tr Ii
REG	Regency Centers Corporation
REG-C	Regency Ctrs Corp
REG-D	Regency Ctrs Corp
REG-E	Regency Ctrs Corp
REP	Repsol Ypf S.a.
REP-A	Repsol Intl Cap Ltd
RES	Rpc, Inc.
REV	Revlon, Inc.
RF	Regions Financing Tr I
RF-Z	REGIONS FINANCING TRUST III
RFI	Cohen & Steers Total Return Realty Fund Inc.
RFO-A	Royce Focus Tr
RGA	Reinsurance Group Of America, Incorporated
RGA-A	Reinsurance Group Amer Inc
RGC	Regal Entertainment Group
RGM	General Motors Corporation
RGR	Sturm, Ruger & Company, Inc.
RGS	Regis Corporation
RHB	Rehabcare Group, Inc.
RHD	R.h. Donnelley Corporation
RHI	Robert Half International Inc.
RHT	Right Mgmt Consultant Inc
RHY	Rmk Multi-sector High Income Fund, Inc.
RIG	Transocean Inc.
RIO	Cia Vale do Rio Doce
RIO.P	Cia Vale do Rio Doce
RIT	Lmp Real Estate Income Fund Inc
RJF	Raymond James Financial, Inc.
RKT	Rock-tenn Company
RL	Polo Ralph Lauren Corporation
RLF	Cohen & Steers Advantage Income Realty Fund Inc.
RLH	Westcoast Hospitality Corporation
RLH-A	Red Lion Hotels Capital Trus
RLI	Rli Corporation
RMA	Rmk Advantage Income Fund, Inc.
RMD	Resmed Inc.
RMG	RISKMETRICS GROUP INC
RMH	Rmk High Income Fund Inc
RMT	Royce Micro-cap Trust, Inc.
RMT-A	Royce Micro-cap Tr Inc
RNE	Morgan Stanley Eastern Europe Fund, Inc.
RNP	Cohen & Steers Reit and Preferred Income Fund Inc
RNR	Renaissancere Holdings Ltd.
RNR-B	Renaissancere Holdings Ltd
RNR-C	Renaissancere Holdings Ltd
RNR-D	Renaissancere Holdings Ltd
RNT	Aaron Rents Inc.
RNT.A	Aaron Rents Inc.
ROC	Rockwood Holdings, Inc.
ROG	Rogers Corporation
ROH	Rohm And Haas Company
ROK	Rockwell Automation Inc
ROL	Rollins, Inc.
ROP	Roper Industries, Inc.
ROS	Rostelecom
RPF	Cohen & Steers Premium Income Realty Fund Inc
RPM	Rpm, Inc.
RPT	Ramco-gershenson Properties Trust
RQI	Cohen & Steers Quality Income Realty Fund Inc
RRC	Range Resources Corporation
RRD	R.r. Donnelley & Sons Company
RRI	Reliant Resources, Inc.
RRR	ROTO ROOTER INC
RS	Reliance Steel & Aluminum Company
RSC	Rex Stores Corporation
RSF	Rmk Strategic Income Fd, Inc
RSG	Republic Services, Inc.
RSH	Radioshack Corporation
RSO	Resource Capital Corp.
RT	Ruby Tuesday Inc
RTI	Rti International Metals, Inc.
RTN	Raytheon Company
RTN.W	RAYTHEON CO. WARRANTS [EXPIRIN
RTP	Rio Tinto Plc
RTU	Cohen & Steers REIT and Utility Income Fund Inc
RUK	Reed Elsevier Plc
RUS	Russ Berrie And Company, Inc.
RVI	Retail Ventures, Inc.
RVT	Royce Value Trust, Inc.
RVT-B	Royce Value Tr Inc
RWF	Cohen & Steers Worldwide Realty Income Fund Inc.
RWT	Redwood Trust, Inc.
RX	Ims Health Incorporated
RY	Royal Bank Of Canada
RYL	Ryland Group, Inc. (the)
RYN	Rayonier Inc. Reit
RZ	RASER TECH INC
S	Sprint  Nextel Corporation
SAB	Grupo Casa Saba, S.a. De C.v.
SAH	Sonic Automotive, Inc.
SAI	Saic Inc
SAM	Boston Beer Company Inc. (The)
SAN	Banco Santiago S.A.
SAP	Sap Aktiengesellschaft Systeme, Anwendungen, Produkte
SAY	Satyam Computer Services
SB	SAFE BULKERS INC
SBH	Sally Beauty Holdings, Inc.
SBP	Santander Bancorp
SBR	Sabine Royalty Trust
SBS	Companhia de saneamento Basico Do Estado De Sao Paulo - Sabesp
SBW	Western Asset Worldwide Income Fund Inc.
SBX	SEABRIGHT IURANCE
SCD	Lmp Capital And Income Fund Inc.
SCG	Scana Corporation
SCG.P	SOUTH CAROLINA ELE
SCI	Service Corporation International
SCL	Stepan Company
SCL.P	SPEPAN 5.5 CVPR
SCR	SIMCERE PHARMACEUTICAL GROUP
SCS	Steelcase Inc.
SCX	L.s. Starrett Company (the)
SD	SANDRIDGE ENERGY INC
SDA	Sadia S.a.
SE	Spectra Energy Corp
SEE	Sealed Air Corporation
SEH	Spartech Corporation
SEL	Seligman Select Municipal Fund, Inc.
SEP	SPECTRA ENERGY PARTERS LP
SF	Stifel Financial Corporation
SFD	Smithfield Foods, Inc.
SFE	Safeguard Scientifics, Inc.
SFG	Stancorp Financial Group, Inc.
SFI	Istar Financial Inc.
SFI-D	Istar Finl Inc
SFI-E	Istar Finl Inc
SFI-F	Istar Finl Inc
SFI-G	Istar Finl Inc
SFI-I	Istar Finl Inc
SFL	Ship Finance International
SFN	Spherion Corporation
SFY	Swift Energy Company
SGA	Saga Communications, Inc.
SGF	Singapore Fund, Inc. (the)
SGK	Schawk, Inc.
SGL	Strategic Global Income Fund, Inc.
SGP	Schering-plough Corp
SGP-B	SCHERING-PLOUGH CORPORATION
SGR	Shaw Group Inc. (the)
SGU	Star Gas Partners, L.p.
SGY	Stone Energy Corporation
SGZ	Selective Insurance Group, Inc.
SHG	Shinhan Financial Group Co Ltd
SHI	Sinopec Shangai Petrochemical Company, Ltd.
SHO	Sunstone Hotel Investors, Inc.
SHO-A	Sunstone Hotel Invs Inc New
SHS	Sauer-danfoss Inc.
SHW	Sherwin-williams Company (the)
SI	Siemens Ag
SID	Companhia Siderurgica Nacional S.a.
SIG	Signet Group Plc
SII	Smith International, Inc.
SIX	Six Flags, Inc.
SIX-B	Six Flags Inc
SJI	South Jersey Industries, Inc.
SJM	J.m. Smucker Company (the)
SJR	Shaw Communications Inc.
SJT	San Juan Basin Royalty Trust
SJW	Sjw Corporation
SKH	SKILLED HEALTHCARE GROUP INC C
SKM	Sk Telecom Corporation, Ltd.
SKS	Saks Incorporated
SKT	Tanger Factory Outlet Centers, Inc.
SKT-C	Tanger Factory Outlet Ctrs I
SKX	Skechers U.s.a., Inc.
SKY	Skyline Corporation
SLA	American Select Portfolio Inc.
SLB	Schlumberger N.v.
SLE	Sara Lee Corporation
SLF	Sun Life Financial Incorporated
SLG	Sl Green Realty Corporation
SLG-C	Sl Green Rlty Corp
SLG-D	Sl Green Rlty Corp
SLH	Strategic Hotel Capital Inc
SLM	Slm Corporation
SLM-A	Slm Corp
SLM-B	Slm Corp
SLS	SELIGMAN LASALLE INTERNATIONAL
SLT	STERLITE INDUSTRIES [INDIA] LI
SLW	Silver Wheaton Corp
SM	St. Mary Land
SMA	Symmetry Medical Inc
SMG	Scotts Company (the)
SMI	Semiconductor  Manufacturing International Corporation
SMP	Standard Motor Products, Inc.
SMS	SIMS GROUP LIMITED
SNA	Snap-on Incorporated
SNE	Sony Corporation
SNF	Spain Fund (the)
SNH	Senior Housing Properties Trust
SNI	SCRIPPS NETWORKS INTERACTIVE I
SNN	Smith & Nephew Snats, Inc.
SNP	China Petroleum & Chemical Corporation
SNS	Steak N Shake Company (the)
SNV	Synovus Financial Corporation
SNX	Synnex Corporation
SNY	Sanofi-aventis Sa
SO	Southern Company (the)
SOA	Southern Africa Fund
SOL	Sola International Inc.
SON	Sonoco Products Company
SOR	Source Capital, Inc.
SOR.P	SOURCE CAPITAL INC PFD
SOV	Sovereign Bancorp, Inc.
SOV-B	Sovereign Cap Tr V
SOV-C	Sovereign Bancorp Inc
SPA	Sparton Corporation
SPF	Standard Pacific Lp
SPG	Simon Property Group, Inc.
SPG-I	Simon Ppty Group Inc New
SPG-J	Simon Ppty Group Inc New
SPH	Suburban Propane Partners, L.p.
SPN	Superior Energy Services, Inc.
SPP	Sappi
SPR	Spirit Aerosystems Holdings, Inc.
SPW	Spx Corporation
SQM	Sociedad Quimica Y Minera S.a.
SR	Standard Register Company (the)
SRE	Sempra Energy
SRI	Stoneridge, Inc.
SRT	Startek, Inc.
SRV	Sierra Pacific Resources
SRX	Sra International, Inc
SRZ	Sunrise Senior Living, Inc.
SSD	Simpson Manufacturing Company, Inc.
SSI	Stage Stores, Inc.
SSL	Sasol Ltd.
SSP	E.W. Scripps Company (The)
SSS	Sovran Self Storage, Inc.
SSW	Seaspan Corporation
STC	Stewart Information Services Corporation
STD	Banco Santander S.A.
STD-A	Banco Santander S.A.
STD-B	Banco Santander S.A.
STD-C	Banco Santander S.A.
STD-I	Banco Santander S.A.
STE	Steris Corporation
STI	Suntrust Banks, Inc.
STI-A	Suntrust Bks Inc
STI-Z	SUNTRUST CAPITAL IX
STJ	St. Jude Medical, Inc.
STL	Sterling Bancorp
STL-A	Sterling Bancorp Tr I
STM	Stmicroelectronics N.v.
STN	Station Casinos, Inc.
STO	Statoil Asa
STP	Suntech Power Holdings Co., Ltd.
STR	Questar Corporation
STT	State Street Corp
STU	Student Loan Corporation (the)
STV	China Digital TV Holding Co. Ltd.
STZ	Constellation Brands Inc.
STZ.B	Constellation Brands Inc.
SU	Suncor Energy  Inc.
SUG	Southern Union Company
SUG-C	Southern Un Co New
SUI	Sun Communities, Inc.
SUN	Sunoco, Inc.
SUP	Superior Industries International, Inc.
SUR	CNA Surety Corporation
SUS-A	SUSQUEHANNA CAPITAL I
SVJ	Savannah Electric And Power Co
SVR	Syniverse Holdings, Inc.
SVU	Supervalu Inc.
SWC	Stillwater Mining Company
SWK	Stanley Works (the)
SWM	Schweitzer-mauduit International, Inc.
SWN	Southwestern Energy Company
SWS	Sws Group, Inc.
SWX	Southwest Gas Corporation
SWX-B	Southwest Gas Cap Ii
SWY	Safeway Inc.
SWZ	Swiss Helvetia Fund, Inc. (the)
SXE	Stanley, Inc.
SXI	Standex International Corporation
SXL	Sunoco Logistics Partners Lp
SXT	Sensient Technologies Corporation
SY	Sybase, Inc.
SYK	Stryker Corporation
SYT	Syngenta Ag
SYX	Systemax Inc.
SYY	Sysco Corporation
T	AT&T Inc.
TAC	Transalta Corporation
TAI	Transamerica Income, Inc.
TAL	Tal International Group, Inc.
TAM	Tam S.a.
TAP	Molson Coors Brewing  Company
TAP.A	Molson Coors Brewing Co
TAR	Telefonica De Argentina Sa
TBH	Telecom Brasil Sa Te
TBI	TOM BROWN INC
TBL	Timberland Company (the)
TC	THOMPSON CREEK METALS CO. INC
TCB	Tcf Financial Corporation
TCB-A	TCF CAPITAL I
TCI	Transcontinental Realty Investors, Inc.
TCK	Teck Cominco Ltd
TCL	TATA COMMUNICATIONS LIMITED
TCM	TONGITANG CHINESE MEDICINES CO
TCO	Taubman Centers, Inc.
TCO-G	Taubman Ctrs Inc
TCO-H	Taubman Ctrs Inc
TD	Toronto Dominion Bank (the)
TDA	Telephone And Data Systems, Inc.
TDC	TERADATA CORPORATION
TDF	Templeton Dragon Fund, Inc.
TDG	Transdigm Group Incorporated
TDI	Telephone And Data Systems, Inc.
TDK	Tdk Corporation
TDS	TELEPHONE + DATA SYS
TDS.S	TEL AND DATA SYS
TDW	Tidewater Inc.
TDY	Teledyne Technologies Incorporated
TE	Teco Energy, Inc.
TEF	Telefonica Sa
TEG	Wps Resources Corporation
TEI	Templeton Emerging Markets Income Fund, Inc.
TEL	TYCO ELECTRONICS LTD. COMMON S
TEN	Tenneco Automotive, Inc.
TEO	Telecom Argentina Stet - France Telecom S.a.
TER	Teradyne, Inc.
TEX	Terex Corporation
TFC	Taiwan Greater China Fund
TFX	Teleflex Incorporated
TG	Tredegar Corporation
TGH	TEXTAINER GROUP HOLDINGS LIMIT
TGI	Triumph Group, Inc.
TGP	Teekay Lng Partners, L.p.
TGS	Transportadora De Gas Del Sur Sa Tgs
TGT	Target Corporation
TGX	Theragenics Corporation
THC	Tenet Healthcare Corporation
THG	Allmerica Financial Corporation
THI	Tim Hortons Inc.
THO	Thor Industries, Inc.
THS	Treehouse Foods, Inc.
TI	Telecom Italia S.p.a.
TI.A	Telecom Italia S P
TIE	Titanium Metals Corporation
TIF	Tiffany & Co.
TII	Thomas Industries, Inc.
TII.A	TELMEX INTERNACIONAL SAB DE CV
TIN	Temple-inland Inc.
TJX	Tjx Companies, Inc. (the)
TK	Teekay Shipping Corporation
TKC	Turkcell Iletisim Hizmetleri As
TKF	Turkish Investment Fund, Inc. (the)
TKG	Telkom Sa Ltd
TKR	Timken Company (the)
TKS	Tomkins Plc
TLB	Talbots, Inc. (the)
TLI	Lmp Corporate Loan Fund Inc
TLK	P.t. Telekomunikasi Indonesia, Tbk.
TLM	Talisman Energy Inc.
TLP	Transmontaigne Partners L.p.
TM	Toyota Motor Corporation
TMB	Telemig Celular Participacoes S.a.
TMK	Torchmark Corporation
TMK-A	Torchmark Cap Tr Iii
TMM	Grupo Tmm, S.a.
TMO	Thermo Fisher Scientific Inc
TMR	Meridian Resource Corporation (the)
TMS	Thomson Multimedia S.a.
TMX	Telefonos De Mexico
TNB	Thomas & Betts Corporation
TNC	Tennant Company
TNE	Tele Norte Leste Participacoes S.a.
TNH	Terra Nitrogen Company, L.p.
TNK	TEEKAY TANKERS LTD
TNL	Technitrol, Inc.
TNP	Tsakos Energy Navigation Ltd
TNS	Tns, Inc.
TOD	Todd Shipyards Corporation
TOL	Toll Brothers Inc.
TOO	Teekay Offshore Partners L.p.
TOT	Totalfinaelf, S.a.
TPL	Texas Pacific Land Trust
TPP	Teppco Partners, L.p.
TPX	Tempur-pedic International Inc
TR	Tootsie Roll Industries, Inc.
TRA	Terra Industries Inc.
TRC	Tejon Ranch Company
TRF	Templeton Russia Fund, Inc.
TRH	Transatlantic Holdings, Inc.
TRI	Triad Hospitals, Inc.
TRK	Speedway Motorsports, Inc.
TRN	Trinity Industries, Inc.
TRP	Transcananda Pipelines, Ltd.
TRR	Trc Companies, Inc.
TRS	TRIMAS CORPORATION
TRU	Torch Energy Royalty Trust
TRV	St. Paul Companies, Inc. (the)
TRW	Trw Automotive Holdings Corporation
TS	Tenaris S.a.
TSI	Tcw Strategic Income Fund, Inc.
TSL	Trina Solar
TSM	Taiwan Semiconductor Manufacturing Company
TSN	Tyson Foods, Inc.
TSO	Tesoro Petroleum Corporation
TSP	Telecomunicacoes De Sao Paulo S.a.
TSS	Total System Services, Inc.
TSU	Tele Celular Sul Participacoes S.a.
TTC	Toro Company (the)
TTF	Thai Fund, Inc. (the)
TTI	Tetra Technologies, Inc.
TTM	Tata Motors Ltd
TTO	Tortoise Capital Resources Corporation
TU	Telus Corporation
TUC	Mac-gray Corporation
TUP	Tupperware Corporation
TV	Grupo Televisa S.a.
TVC	Tennessee Valley Authority
TVE	Tennessee Valley Authority
TVL	Lin Tv Corp
TWB	Tween Brands, Inc.
TWC	TIME WARNER CABLE CLASS A
TWI	Titan International, Inc.
TWN	Taiwan Fund, Inc. (the)
TWP	Trex Company, Inc.
TWX	Time Warner Inc.
TX	Ternium S.a.
TXI	Texas Industries, Inc.
TXN	Texas Instruments Incorporated
TXT	Textron Inc.
TXT-A	Textron Inc
TY	Tri Contl Corp
TY.P	TRI CONTINENTAL CP PFD
TYC	Tyco International, Ltd.
TYG	Tortoise Energy Infrastructure Corporation
TYL	Tyler Technologies, Inc.
TYN	Tortoise North American Energy Corporation
TYW	Ts&w/claymore Tax-advantaged Balanced Fund
TYY	Tortoise Energy Capital Corporation
TZF	Bear Stearns Depositor Inc.
TZK	Trust Ctfs 2002 1 Bear Stearns Depositor Inc Acting As Deposit
UA	Under Armour, Inc.
UAM	UNIVERSAL AMERICAN
UBA	Urstadt Biddle Properties Inc.
UBB	Unibanco Brasileiros S.a.
UBP	Urstadt Biddle Properties Inc.
UBP-C	Urstadt Biddle Pptys Ins
UBP-D	Urstadt Biddle Pptys Ins
UBS	Ubs Ag
UBS-D	Ubs Pfd Fdg Tr Iv
UDR	United Dominion Realty Trust, Inc.
UDR-G	UDR INC 6.75% SERIES G
UFI	Unifi, Inc.
UFS	Domtar Corporation
UGI	Ugi Corporation
UGP	Ultrapar Participacoes S.a.
UHS	Universal Health Services, Inc.
UHT	Universal Health Realty Income Trust
UIL	Uil Holdings Corporation
UIS	Unisys Corporation
UL	Unilever Plc
UMC	United Microelectronics Corporation
UN	Unilever Nv
UNF	Unifirst Corporation
UNH	Unitedhealth Group Incorporated
UNM	Unumprovident Corporation
UNP	Union Pacific Corporation
UNS	Unisource Energy Corporation
UNT	Unit Corporation
UPL	ULTRA PETROLEUM CORP
UPS	United Parcel Service, Inc.
URI	United Rentals, Inc.
URS	Urs Corporation
USA	Liberty All-star Equity Fund
USB	U.s. Bancorp
USB-E	Usb Cap Vi
USB-F	Usb Cap Vii
USB-G	Usb Cap Viii
USB-H	Us Bancorp Del
USB-I	Usb Cap X
USB-J	Usb Cap Xi
USB-K	Usb Cap Xii
USB-L	U S BANCORP SERIES D
USG	Usg Corporation
USM	U S CELLULAR
UST	Ust Inc.
USU	Usec Inc.
UTF	Cohen & Steers Select Utility Fund
UTI	Universal Technical Institute Inc
UTL	UNITIL CP
UTR	Unitrin, Inc.
UTX	United Technologies Corporation
UVV	Universal Corporation
UZG	United States Cellular Corporation
UZV	United States Cellular Corporation
V	Visa, Inc
VAL	Valspar Corporation (the)
VAR	Varian Medical Systems, Inc.
VBF	Van Kampen Bond Fund
VC	Visteon Corporation
VCI	Valassis Communications, Inc.
VCO	Vina Concha Y Toro
VCP	Votorantim Celulose E Papel Sa
VCV	Van Kampen California Value Municipal Income Trust
VE	Vivendi Environnement Ord
VEL-E	Virginia Elec & Pwr Co
VFC	V.f. Corporation
VG	Vonage Holdings Corp.
VGM	Van Kampen Trust For Investment Grade Municipals
VGR	Vector Group Ltd.
VHI	Valhi, Inc.
VIA	Viacom, Inc.
VIA.B	Viacom, Inc.
VIM	Van Kampen Trust For Insured Municipals
VIP	Open Joint Stock Company Vimpel-communications
VIT	Van Kampen High Income Corporate Bond Fund
VIV	Vivo Participacoes S.a.
VKQ	Van Kampen Municipal Trust
VLO	Valero Energy Corporation
VLT	Van Kampen High Income Corporate Bond Fund
VLY	Valley National Bancorp
VLY-A	Vnb Cap Tr I
VM	VIRGIN MOBILE USA INC
VMC	Vulcan Materials Company
VMI	Valmont Industries, Inc.
VMO	Van Kampen Municipal Opportunity Trust
VMW	VMWARE INC.
VNO	Vornado Realty Trust
VNO-A	Vornado Rlty Tr
VNO-E	Vornado Rlty Tr
VNO-F	Vornado Rlty Tr
VNO-G	Vornado Rlty Tr
VNO-H	Vornado Rlty Tr
VNO-I	Vornado Rlty Tr
VNV	Viacom, Inc.
VOD	Vodafone Airtouch Public Company
VOL	Volt Information Sciences, Inc.
VOQ	Van Kampen Ohio Quality Municipal Trust
VPV	Van Kampen Pennsylvania Value Municipal Income Trust
VQ	Venoco, Inc.
VR	VALIDUS HOLDINGS
VRS	VERSO PAPER CORP
VRX	Valeant Pharmaceuticals International
VSH	Vishay Intertechnology, Inc.
VTA	Vesta Insurance Group, Inc.
VTJ	Van Kampen Trust For Investment Grade New Jersey Municipals
VTN	Van Kampen Trust For Investment Grade New York Municipals
VTO	Vitro S.a. De C.v.
VTR	Ventas, Inc.
VVC	Vectren Corporation
VVI	Viad Corporation
VVR	Van Kampen Senior Income Trust
VZ	Verizon Communications Inc.
WAB	Wabtec Corporation
WAG	Walgreen Company
WAL	Western Alliance Bancorporation
WAT	Waters Corporation
WB	Wachovia Corporation
WB-B	WACHOVIA CAPITAL TRUST IV
WB-C	WACHOVIA CAPITAL TRUST IX
WB-D	WACHOVIA CAPITAL TRUST X
WB-S	WACHOVIA CORPORATION 8.00%
WB-T	WACHOVIA  7.50% CLA
WBC	WABCO HOLDINGS INC
WBD	Wimm Bill Dann Foods Ojsc
WBK	Westpac Banking Corporation
WBS	Webster Financial Corporation
WCC	Wesco International, Inc.
WCG	Wellcare Group
WCN	Waste Connections Inc.
WCO	WELLS FARGO CAPITAL XIV 8.625%
WDC	Western Digital Corporation
WDR	Waddell & Reed Financial, Inc.
WEA	Western Asset Bond Fund
WEC	Wisconsin Energy Corporation
WEN	Wendy's International, Inc.
WES	WestCorp
WF	Woori Finance Holdings Co Ltd
WFC	Wells Fargo & Company
WFC-J	WELLS FARGO PFD J
WFC-L	WELLS FARGO PFD L
WFR	Memc Electronic Materials, Inc.
WFT	Weatherford International, Inc.
WG	Willbros Group, Inc.
WGL	Washington Gas Light Company
WGO	Winnebago Industries, Inc.
WH	WSP HOLDINGS LIMITED
WHG	Westwood Holdings Group Inc
WHI	W Holding Company Incorporated
WHR	Whirlpool Corporation
WHX	WHX Corporation
WIA	Western Asset/claymore U.s. Treasury Inflation Prot Secs Fd
WIN	Windstream Corporation
WIT	Wipro
WIW	Western Asset/claymore U.s Treasury Inflation Prot Secs Fd 2
WL	Wilmington Trust Corporation
WLK	Westlake Chemical Corporation
WLL	Whiting Petroleum Corporation
WLP	Wellpoint Health Networks Inc.
WLT	Walter Industries, Inc.
WMB	Williams Companies, Inc. (the)
WMG	Warner Music Group Corp.
WMI	Waste Management, Inc.
WMK	Weis Markets, Inc.
WMS	Wms Industries Inc.
WMT	Wal-mart Stores, Inc.
WMZ	WILLIAMS PIPELINE PARTNERS LP
WNA.P	WACHOVIA PRF FUNDING CP PFD
WNC	Wabash National Corporation
WNI	Weider Nutrition International, Inc.
WNR	Western Refining, Inc.
WNS	Wns (holdings)
WOR	Worthington Industries, Inc.
WPC	W.p. Carey & Co. Llc
WPI	Watson Pharmaceuticals, Inc.
WPK	Wells Fargo & Company
WPL	W.p. Stuart & Co., Ltd.
WPO	Washington Post Company (the)
WPP	Wausau-mosinee Paper Corporation
WPZ	Williams Partners L.p.
WR	Westar Energy, Inc.
WRB	W R BERKLEY CORPORATION
WRB-A	W R BERKLEY CAPITAL TRUST II
WRC	WORLD COLOR PRESS INC
WRE	Washington Real Estate Investment Trust
WRI	Weingarten Realty Investors
WRI-D	Weingarten Rlty Invs
WRI-E	Weingarten Rlty Invs
WRI-F	Weingarten Rlty Invs
WRS	Windrose Med Pptys Tr
WSF	Wells Fargo & Company
WSH	Willis Group Holdings
WSM	Williams-sonoma, Inc.
WSO	Watsco, Inc.
WST	West Pharmaceutical Services, Inc.
WTI	W&t Offshore, Inc.
WTM	White Mountains Insurance Group, Ltd.
WTR	Aqua America Inc.
WTS	Watts Water Technologies, Inc.
WTU	Williams Coal Seam Gas Royalty Trust
WTW	Weight Watchers International Inc
WU	Western Union Company (the)
WW	Watson Wyatt & Company Holdings
WWE	World Wrestling Entertainment, Inc.
WWW	Wolverine World Wide, Inc.
WX	WUXI PHARMATECH [CAYMAN] INC.
WXS	Wright Express Corporation
WY	Weyerhaeuser Company
WYE	Wyeth
WYN	Wyndham Worldwide Corp
X	Usx Corporation
XAA	American Municipal Income Portfolio
XCJ	XCEL ENERGY INC
XCO	Exco Resources, Inc.
XEC	Cimarex Energy Co
XEL	Xcel Energy Inc.
XEL-A	Xcel Energy Inc
XEL-B	Xcel Energy Inc
XEL-C	Xcel Energy Inc
XEL-D	Xcel Energy Inc
XEL-E	Xcel Energy Inc
XFB	Lehman Abs Corporation
XFD	Lehman Abs Corporation
XFH	Lehman Abs Corporation
XFJ	Lehman Abs Corporation
XFL	Lehman Abs Corporation
XFP	Lehman Abs Corporation
XFR	Lehman Abs Corporation
XGM	General Motors Corporation
XIN	XINYUAN REAL ESTATE CO LTD
XJT	Expressjet Holdings Inc
XKE	Lehman Abs Corporation
XKK	Lehman Abs Corporation
XKN	Lehman Abs Corporation
XKO	Lehman Abs Corporation
XL	Xl Capital
XL-X	Xl Cap Ltd
XL-Y	XL CAPITAL LTD EQTY SECURITY U
XOM	Exxon Mobil Corporation
XRM	Xerium Technologies, Inc.
XRX	Xerox Corporation
XTO	Xto Energy Inc.
XVF	Lehman Abs Corp
XVG	Lehman Abs Corporation
Y	Alleghany Corporation
YGE	YINGLI GREEN ENERGY HOLDING CO
YPF	Ypf Sociedad Anonima
YSI	U-store-it Trust
YUM	Yum! Brands, Inc.
YZC	Yanzhou Coal Mining Company
ZAP	Zapata Corporation
ZB-A	Zions Bancorporation
ZB-B	Zions Cap Tr B
ZB-C	ZIO BANCORPORATION
ZEP	ZEP INC
ZF	Zweig Fund, Inc. (the)
ZLC	Zale Corporation
ZMH	Zimmer Holdings, Inc.
ZNH	China Southern Airlines Company
ZNT	Zenith National Insurance Corporation
ZQK	Quiksilver, Inc.
ZTR	Zweig Total Return Fund, Inc. (the)
ZZ	Sealy Corporation
